border_size=1
usage=map

Hh          , Mm          , Mm^Xm       , Mm^Xm       , Mm^Xm       , Gs^Fp       , Gs^Fp       , Hh          , Hh          , Gs^Fp       , Gs^Fp       , Hh          , Hh          , Gs^Fp       , Hh          , Hh          , Hh          , Gs^Fp       , Hh          , Gs^Fp       , Gs^Fp       , Gs^Fp       , Gs          , Gs          , Gs          , Gs          , Gs          , Gs^Fp       , Gs^Fp       , Gs^Fp       , Gs^Fp       , Gs          , Gs          , Gs          , Gs          , Gs^Fp       , Gs^Fp       , Gs^Fp       , Gs          , Rd          , Gs          , Gs          , Gs          , Gs^Fp       , Hh          , Mm          , Mm          , Mm          , Mm^Xm       , Mm^Xm       , Mm^Xm       , Mm^Xm       
Hh          , Hh          , Mm          , Mm^Xm       , Mm          , Mm          , Gs^Fp       , Hh          , Mm          , Gs^Fp       , Gs^Fp       , Hh          , Gs^Fp       , Gs^Fp       , Gs^Fp       , Gs^Fp       , Hh          , Hh          , Gs^Fp       , Gs^Fp       , Gs^Fp       , Gs^Fp       , Gs          , Gs^Fy       , Ce          , Gs          , Gs^Vht      , Gs^Fp       , Gs^Fp       , Gs^Fp       , Gs^Fp       , Gs          , Gs          , Gs          , Gs          , Gs^Fp       , Gs^Fp       , Gs^Fp       , Gs          , Rd          , Gs          , Gs          , Gs^Fp       , Hh          , Hh          , Mm          , Mm          , Mm^Xm       , Mm^Xm       , Mm^Xm       , Mm^Xm       , Mm^Xm       
Gs^Fp       , Hh          , Hh          , Mm^Xm       , Hh          , Gs^Fp       , Hh          , Hh          , Mm^Xm       , Hh          , Gs^Fp       , Gs^Fp       , Gs^Fp       , Gs^Fp       , Gs^Fp       , Gs^Fp       , Hh          , Hh          , Gs          , Gs          , Gs          , Gs^Vht      , Gs          , Ce          , 3 Ke        , Ce          , Gs^Fy       , Gs          , Gs^Fp       , Gs^Fp       , Gs^Fp       , Gs          , Gs^Fp       , Gs          , Gs          , Gs^Fp       , Gs          , Gs^Fp       , Rd          , Rd          , Gs^Fp       , Gs^Fp       , Hh          , Hh          , Hh          , Hh          , Mm^Xm       , Mm^Xm       , Mm^Xm       , Mm^Xm       , Hh          , Hh          
Mm^Xm       , Gs^Fp       , Hh          , Mm^Xm       , Hh          , Hh          , Mm          , Mm^Xm       , Mm          , Hh          , Gs^Fp       , Gs^Fp       , Gs^Fp       , Gs^Fp       , Gs^Fp       , Gs^Fp       , Gs^Fp       , Gs^Fp       , Gs          , Gs          , Gs^Fp       , Gs          , Gs^Fy       , Ce          , Ce          , Ce          , Gs          , Gs          , Gs^Fp       , Gs^Fp       , Gs^Fp       , Gs^Fp       , Gs^Fp       , Gs          , Gg          , Gg^Ve       , Rd          , Rd          , Gg          , Gs          , Gs^Fp       , Gs^Fp       , Hh          , Mm          , Mm^Xm       , Mm^Xm       , Mm          , Mm^Xm       , Mm^Xm       , Mm          , Mm          , Hh          
Mm^Xm       , Mm          , Hh          , Mm          , Hh          , Hh          , Hh          , Hh          , Gs^Fp       , Gs^Fp       , Gs^Fp       , Gs^Fp       , Gs^Fp       , Gs^Fp       , Gs^Fp       , Gs^Fp       , Gs^Fp       , Gs^Fp       , Gs^Fp       , Gs^Fp       , Gs          , Gs          , Gs          , Gs^Vht      , Gs          , Gs          , Gs          , Gs^Fp       , Gs          , Gs^Fp       , Gs^Fp       , Gs^Fp       , Gs^Fp       , Gs          , Gg          , Ggf         , Rd          , Gg          , Gg          , Gg          , Gg          , Gs^Fp       , Hh          , Mm          , Mm^Xm       , Hh          , Mm          , Mm^Xm       , Mm^Xm       , Mm          , Mm          , Mm          
Mm          , Hh          , Hh          , Hh          , Mm^Xm       , Hh          , Mm          , Hh          , Gs^Fp       , Gs^Fp       , Gs^Fp       , Gs^Fp       , Gs^Fp       , Gs^Fp       , Gs^Fp       , Gs^Fp       , Gs^Fp       , Gs^Fp       , Rd          , Rd          , Rd          , Rd          , Rd          , Rd          , Rd          , Rd          , Rd          , Rd          , Rd          , Gs          , Gs          , Gs^Fp       , Gs^Fp       , Gg          , Gg          , Rd          , Gg          , Gg          , Gs          , Gg          , Gs^Fp       , Ggf         , Hh          , Mm          , Mm^Xm       , Hh          , Hh          , Mm          , Mm^Xm       , Mm^Xm       , Mm          , Mm          
Gg          , Gs^Fp       , Gs^Fp       , Mm          , Mm          , Mm          , Hh          , Mm          , Gs^Fp       , Gs          , Gs          , Gs^Fp       , Gs          , Gs          , Gs          , Gs^Fp       , Rd          , Rd          , Gs          , Gs          , Gs          , Gs          , Gs          , Gs          , Gs          , Gs          , Gs          , Gs          , Gs          , Rd          , Rd          , Rd          , Rd          , Gs^Fp       , Rd          , Rd          , Gg          , Ggf         , Gg          , Gg          , Gg          , Gg          , Mm          , Mm          , Mm^Xm       , Mm^Xm       , Mm^Xm       , Mm          , Mm^Xm       , Mm^Xm       , Mm          , Mm          
Gs^Fp       , Gs^Fp       , Gs^Fp       , Hh          , Hh          , Mm          , Gs^Fp       , Hh          , Gs^Fp       , Gs          , Gs          , Gg          , Gg          , Gs          , Gs          , Rd          , Gs          , Gs          , Gs          , Gs^Fp       , Gs^Fp       , Gs          , Gs          , Gs          , Gs          , Gs^Fp       , Gs^Fp       , Gs^Fp       , Gs          , Gs          , Gs          , Gs          , Gs^Fp       , Rd          , Gs          , Rd          , Rd          , Gg          , Ggf         , Gg          , Hh          , Gg          , Hh          , Mm          , Mm^Xm       , Mm^Xm       , Mm          , Mm^Xm       , Mm^Xm       , Mm^Xm       , Hh          , Mm          
Gs^Fp       , Gs^Fp       , Gs^Fp       , Hh          , Hh          , Hh          , Gs^Fp       , Gs^Fp       , Gs^Fp       , Gs          , Gs          , Gs^Fp       , Gg          , Gg          , Gs          , Rd          , Rd          , Gs^Fp       , Gs^Fp       , Gs^Fp       , Gs^Fp       , Gs^Fp       , Gs^Fp       , Gs^Fp       , Gs^Fp       , Gs^Fp       , Gs          , Gs          , Gs          , Gs          , Gg          , Gs^Fp       , Gs          , Gs          , Gs          , Gs          , Gg          , Rd          , Gg          , Hh          , Mm          , Hh          , Mm          , Mm          , Mm^Xm       , Mm          , Mm          , Mm          , Mm^Xm       , Mm^Xm       , Mm          , Mm          
Gs          , Gs^Fp       , Gg          , Gs^Fp       , Gg          , Gs^Fp       , Gs          , Gs          , Gs^Fp       , Gs          , Gs          , Gs          , Gg          , Gg          , Gg          , Gs          , Gs          , Rd          , Gs^Fp       , Gs^Fp       , Gs^Fp       , Gs^Fp       , Ggf         , Gs^Fp       , Gs^Fp       , Gs^Fp       , Gs^Fp       , Gs^Fp       , Gs          , Gs^Fp       , Gg          , Gs^Fp       , Gs^Fp       , Gs          , Gs          , Gs          , Gg          , Rd          , Gs^Fp       , Hh          , Hh          , Mm          , Ch          , Ch          , Mm          , Mm^Xm       , Mm          , Hh          , Mm^Xm       , Mm^Xm       , Mm          , Mm          
Gs          , Gs          , Gs          , Gg          , Gs          , Gs          , Gs          , Gg^Vh       , Gs          , Gs          , Gs          , Gs          , Gs          , Gg          , Gs          , Gs          , Gs^Fp       , Rd          , Rd          , Gs^Fp       , Gs^Fp       , Gs^Fp       , Gg          , Gg          , Ggf         , Gs^Fp       , Gs^Fp       , Gs^Fp       , Gs^Fp       , Gs^Fp       , Gg          , Gs^Fp       , Gs^Fp       , Gs          , Gs          , Gg          , Gs^Fp       , Rd          , Rd          , Gg          , Ggf         , Hh          , Mm          , Ch          , Mm          , Mm^Xm       , Mm^Xm       , Mm^Xm       , Hh          , Mm^Xm       , Mm^Xm       , Mm          
Gs          , Gs          , Gs          , Gs          , Gs          , Gs          , Gs          , Gs          , Gs          , Gs          , Gs          , Gs          , Gs          , Gs          , Gs          , Gs          , Gs^Fp       , Gs^Fp       , Rd          , Gs^Fp       , Gs^Fp       , Gs^Fp       , Gs^Fp       , Ggf         , Gs^Fp       , Gs^Fp       , Gs^Fp       , Gs^Fp       , Gs^Fp       , Gs^Fp       , Gs^Fp       , Gs^Fp       , Gs^Fp       , Gs^Fp       , Gs^Fp       , Hh          , Hh          , Gs^Fp       , Gg          , Re          , Gg          , Hh          , Gs^Fp       , Hh          , Hh          , Mm^Xm       , Mm          , Mm          , Mm          , Mm          , Mm          , Mm^Xm       
Gs^Fp       , Gs          , Gs          , Gs          , Gs^Fp       , Gs          , Gs          , Gs          , Gs          , Gs^Fp       , Gg          , Gs          , Gs          , Gs          , Gs          , Gs          , Gs^Fp       , Gs          , Rd          , Gg^Ve       , Ggf         , Gs^Fp       , Ggf         , Ggf         , Ggf         , Gg          , Gs^Fp       , Gs^Fp       , Gs^Fp       , Gs^Fp       , Ww          , Gs^Fp       , Gs^Fp       , Gs^Fp       , Hh          , Mm          , Mm          , Hh          , Hh          , Re          , Re          , Gg          , Ch          , Gs^Fp       , Gs^Fp       , Mm          , Gs^Fp       , Hh^Vhh      , Gs^Fp       , Mm          , Mm          , Mm          
Gs          , Gs          , Gg^Wm       , Gs          , Gg          , Gs^Fp       , Gs          , Gs          , Gg          , Gg          , Gg          , Gg          , Gs          , Gs          , Gs          , Gs          , Gs          , Gs          , Rd          , Gs          , Gs^Fp       , Gs^Fp       , Gg          , Ggf         , Gg          , Ggf         , Gs^Fp       , Gs^Fp       , Ww          , Hh          , Ww          , Ww          , Hh          , Gs^Fp       , Mm          , Mm^Xm       , Ch          , Mm          , Hh          , Gs^Fp       , Gs          , Rd          , Re          , Gs^Fp       , Hh          , Mm          , Hh          , Gs          , Gs^Fp       , Hh          , Gs^Fp       , Mm          
Re^Gvs      , Re^Gvs      , Re^Gvs      , Gg          , Ce          , Gg          , Gg          , Gg          , Gg          , Gg          , Gg          , Gg          , Gs          , Gs          , Gs          , Gs          , Rd          , Rd          , Gs          , Gs          , Gs^Fp       , Gs^Fp       , Gg          , Ggf         , Gs^Fp       , Ggf         , Ww          , Gs^Fp       , Ww          , Wo          , Wo          , Ww          , Hh          , Gs^Fp       , Mm          , Mm^Xm       , Ch          , Ch          , Mm          , Hh          , Gs          , Gs          , Re          , Gs          , Gs          , Hh          , Re          , Gs          , Ch          , Gs^Fp       , Gs          , Hh          
Re^Gvs      , Re^Gvs      , Gg          , Ce          , 1 Ke        , Ce          , Gs^Fp       , Gs^Fp       , Gs^Fp       , Gg          , Rd          , Rd          , Rd          , Rd          , Rd          , Rd          , Gg          , Gs^Fp       , Gs^Fp       , Gs^Fp       , Gs^Fp       , Gs^Fp       , Gs^Fp       , Gs^Fp       , Gs^Fp       , Ww          , Ww          , Ww          , Ww          , Wo          , Ww          , Ww          , Ww          , Hh          , Hh          , Mm^Xm       , Mm^Xm       , Hh          , Mm^Xm       , Gs^Fp       , Gs^Fp       , Ch          , Gs          , Re          , Re          , Re          , Rd          , Gg^Vh       , Rd          , Re          , Re          , Gs          
Rp          , Gg          , Gg          , Ce          , Ce          , Ce          , Gg          , Gs^Fp       , Rp          , Rd          , Gg          , Gg          , Gg          , Gg          , Gg          , Gs^Fp       , Gs^Fp       , Gs^Fp       , Gs^Fp       , Gs^Fp       , Gs^Fp       , Gs^Fp       , Gs^Fp       , Gs^Fp       , Ww          , Ww          , Wo          , Wo          , Ww          , Hh          , Gs^Fp       , Hh          , Gs^Fp       , Gg          , Gs^Fp       , Mm          , Mm^Xm       , Hh          , Mm^Xm       , Mm          , Gs^Fp       , Gs^Fp       , Gs^Fp       , Gs          , Gg          , Ggf         , Ch          , Re          , Ch          , Ch          , Ch          , Rd          
Gg          , Rp          , Rp          , Rp          , Rp          , Rp          , Rp          , Rp          , Gg          , Gs^Fp       , Gg          , Gg^Vh       , Re^Gvs      , Gg          , Gg          , Gg          , Gs^Fp       , Gs^Fp       , Hh          , Gs^Fp       , Hh          , Gs^Fp       , Hh          , Hh          , Ww          , Wo          , Ww          , Wo          , Ww          , Gs^Fp       , Gs^Fp       , Gs^Fp       , Gs^Fp       , Hh          , Hh          , Gs^Fp       , Gs^Fp       , Mm^Xm       , Mm          , Mm^Xm       , Mm          , Ch          , Ch          , Hh^Vhh      , Gg          , Hh          , Ch          , Rd          , Ch          , 2 Kh        , Ch          , Gs^Fp       
Gg          , Gg          , Gg          , Gg          , Gg          , Gg          , Gg          , Gg          , Gs^Fp       , Gs^Fp       , Re^Gvs      , Re^Gvs      , Re^Gvs      , Re^Gvs      , Gs^Fp       , Gg          , Gs^Fp       , Gs^Fp       , Gs^Fp       , Hh          , Hh          , Hh          , Gs^Fp       , Gs^Fp       , Ww          , Ww          , Gs^Fp       , Ww          , Ww          , Ww          , Gs^Fp       , Gs^Fp       , Gs^Fp       , Hh          , Mm          , Mm          , Gs^Fp       , Gs^Fp       , Mm          , Mm^Xm       , Hh          , Mm          , Mm          , Hh          , Mm          , Gg          , Gg          , Re          , Re          , Ch          , Gg^Vh       , Gs^Fp       
Gs^Fp       , Gg^Ve       , Re^Gvs      , Re^Gvs      , Re^Gvs      , Gg          , Gg          , Gs^Fp       , Gg^Wm       , Re^Gvs      , Re^Gvs      , Re^Gvs      , Gs^Fp       , Gs^Fp       , Gs^Fp       , Gg          , Gs^Fp       , Hh          , Hh          , Hh          , Hh          , Hh          , Gs^Fp       , Gs^Fp       , Gs^Fp       , Ww          , Gs^Fp       , Gs^Fp       , Gs^Fp       , Hh          , Hh          , Gs^Fp       , Hh          , Hh          , Mm          , Mm          , Gs^Fp       , Gs^Fp       , Mm          , Mm^Xm       , Hh          , Mm          , Mm          , Mm          , Mm          , Gg          , Mm          , Ggf         , Gs^Fp       , Hh          , Gs^Fp       , Hh          
Gs^Fp       , Gs^Fp       , Gs^Fp       , Re^Gvs      , Gs^Fp       , Gs^Fp       , Gs^Fp       , Gg          , Gs^Fp       , Gs^Fp       , Gs^Fp       , Gs^Fp       , Gs^Fp       , Gs^Fp       , Gs^Fp       , Gs^Fp       , Gs^Fp       , Hh          , Hh          , Gs^Fp       , Hh          , Hh          , Hh          , Gs^Fp       , Gs^Fp       , Gs^Fp       , Gs^Fp       , Gs^Fp       , Gs^Fp       , Hh          , Gs^Fp       , Hh          , Hh          , Gs^Fp       , Mm          , Mm          , Hh          , Hh          , Mm^Xm       , Mm^Xm       , Hh          , Mm          , Mm          , Mm          , Mm          , Ch          , Hh          , Mm^Vhh      , Mm          , Gs^Fp       , Gs^Fp       , Gs^Fp       
Gs^Fp       , Gs^Fp       , Gs^Fp       , Gs^Fp       , Gs^Fp       , Gs^Fp       , Gs^Fp       , Gs^Fp       , Gs^Fp       , Gs^Fp       , Gs^Fp       , Gs^Fp       , Gs^Fp       , Gs^Fp       , Gs^Fp       , Gs^Fp       , Gs^Fp       , Gs^Fp       , Gs^Fp       , Gs^Fp       , Gs^Fp       , Gs^Fp       , Gs^Fp       , Gs^Fp       , Gs^Fp       , Gs^Fp       , Gs^Fp       , Gs^Fp       , Gs^Fp       , Hh          , Gs^Fp       , Hh          , Gs^Fp       , Mm          , Mm          , Hh          , Mm          , Mm          , Mm^Xm       , Mm          , Hh          , Hh          , Mm          , Mm          , Hh          , Hh          , Hh          , Mm          , Mm          , Mm          , Mm          , Mm          
