border_size=1
usage=map

Mm          , Aa          , Ha          , Aa          , Ha          , Aa          , Ha          , Aa          , Ha          , Aa          , Aa          , Aa          , Aa          , Aa          , Ha          , Aa          , Ha          , Aa          , Mm          , Aa          
Mm          , Mm^Xm       , Ha          , Ha          , Ha          , Aa^Fpa      , Aa^Fpa      , Mm          , Gs^Fp       , Gs^Fp       , Aa^Fpa      , Aa          , Aa          , Ha          , Aa          , Gs^Fp       , Aa^Fpa      , Mm          , Mm          , Mm          
Mm          , Mm^Xm       , Mm^Xm       , Ha          , Ha          , Mm^Xm       , Mm          , Gs^Fp       , Aa^Fpa      , Gs^Fp       , Aa^Fpa      , Gs          , Gs          , Aa          , Gs^Fp       , Gs^Fp       , Aa^Fpa      , Aa^Fpa      , Mm          , Mm          
Mm          , Mm^Xm       , Mm^Xm       , Mm^Xm       , Mm          , Mm^Xm       , Gs^Fp       , Gs^Fp       , Aa^Fpa      , Aa^Fpa      , Ha          , Ha          , Aa          , Gs          , Gs^Fp       , Aa^Fpa      , Mm          , Mm          , Mm          , Mm          
Mm          , Mm^Xm       , Mm          , Mm          , Ha          , Hh          , Aa^Fpa      , Hh          , Gs^Fp       , Aa^Fpa      , Aa^Fpa      , Aa          , Aa^Fpa      , Aa          , Gs          , Gs^Fp       , Hh          , Mm          , Mm^Xm       , Mm          
Mm          , Mm          , Mm^Xm       , Mm          , Mm          , Mm          , Aa^Fpa      , Aa^Fpa      , Aa          , Aa          , Aa^Fpa      , Aa          , Aa^Fpa      , Aa          , Gs          , Aa^Fpa      , Gg          , Mm          , Mm^Xm       , Mm          
Mm          , Mm^Xm       , Mm^Xm       , Mm^Xm       , Ha          , Ha          , Aa^Fpa      , Aa          , Gs          , Aa          , Aa          , Aa^Fpa      , Gs          , Gs          , Aa^Fpa      , Aa^Fpa      , Mm          , Mm          , Mm^Xm       , Mm          
Mm          , Mm          , Mm^Xm       , Mm^Xm       , Ha          , Mm^Xm       , Aa^Fpa      , Aa          , Gs          , Aa          , Aa^Fpa      , Aa^Fpa      , Ha          , Aa          , Aa^Fpa      , Hh          , Mm          , Mm^Xm       , Mm^Xm       , Mm          
Mm          , Mm          , Mm          , Mm^Xm       , Mm          , Mm          , Mm          , Mm          , Ha          , Aa^Fpa      , Aa^Fpa      , Aa^Fpa      , Aa          , Hh          , Mm          , Mm          , Mm^Xm       , Mm^Xm       , Mm^Xm       , Mm          
Mm          , Mm          , Mm^Xm       , Mm^Xm       , Mm          , Mm          , Ha          , Hh          , Aa^Fpa      , Gs^Fp       , Aa^Fpa      , Aa          , Gs^Fp       , Hh          , Mm          , Mm^Xm       , Mm^Xm       , Mm          , Mm^Xm       , Mm          
Mm          , Mm^Xm       , Mm^Xm       , Mm          , Mm          , Mm          , Ha          , Ha          , Aa^Fpa      , Aa^Fpa      , Aa          , Aa          , Gs^Fp       , Aa^Fpa      , Mm          , Mm          , Mm          , Mm          , Mm^Xm       , Mm          
Mm          , Mm          , Mm^Xm       , Mm          , Hh          , Hh          , Aa^Fpa      , Gs^Fp       , Gs          , Aa          , Aa^Fpa      , Aa          , Aa          , Hh          , Aa^Fpa      , Mm          , Mm          , Mm^Xm       , Mm^Xm       , Mm          
Mm          , Mm          , Mm^Xm       , Ha          , Ha          , Ha          , Ha          , Gs^Fp       , Gs          , Aa^Fpa      , Gs^Fp       , Gs^Fp       , Aa^Fpa      , Gs          , Gs          , Hh          , Aa^Fpa      , Mm          , Mm          , Mm          
Mm          , Mm          , Mm^Xm       , Ha          , Mm          , Ha          , Ha          , Aa          , Gs          , Gs          , Aa          , Aa          , Gs^Fp       , Aa          , Gs          , Aa^Fpa      , Ha          , Mm          , Mm          , Mm          
Mm          , Mm          , Mm^Xm       , Mm^Xm       , Ha          , Ha          , Hh          , Gs^Fp       , 1 Gs        , Aa^Fpa      , Gs          , Aa          , Gs^Fp       , Aa^Fpa      , Aa^Fpa      , Aa^Fpa      , Mm          , Mm          , Ha          , Mm          
Mm          , Mm^Xm       , Mm          , Ha          , Mm          , Mm          , Ha          , Gs^Fp       , Gs^Fp       , Gs          , Aa          , Aa^Fpa      , Gs^Fp       , Gs^Fp       , Ha          , Hh          , Hh          , Ha          , Mm          , Mm          
Mm          , Mm^Xm       , Mm^Xm       , Mm          , Mm          , Mm          , Ha          , Ha          , Mm          , Gs          , Gs          , Aa          , Aa^Fpa      , Ha          , Mm          , Hh          , Mm^Xm       , Mm          , Mm          , Mm          
Mm          , Mm^Xm       , Mm^Xm       , Mm          , Mm          , Mm          , Mm          , Mm          , Mm          , Mm          , Gs          , Aa          , Mm          , Mm^Xm       , Mm^Xm       , Mm^Xm       , Mm^Xm       , Mm^Xm       , Mm^Xm       , Mm          
Xu          , Xu          , Mm^Xm       , Mm^Xm       , Mm^Xm       , Mm^Xm       , Xu          , Mm^Xm       , Xu          , Mm          , Gs          , Gs          , Xu          , Mm^Xm       , Xu          , Xu          , Xu          , Xu          , Xu          , Xu          
Xu          , Xu          , Xu          , Xu          , Xu          , Xu          , Xu          , Xu          , Xu          , Uu^Ii       , Uu^Ii       , Uu^Ii       , Xu          , Xu          , Xu          , Xu          , Xu          , Xu          , Xu          , Xu          
Xu          , Xu          , Xu          , Xu          , Xu          , Xu          , Xu          , Xu          , Xu          , Uu^Ii       , Uu^Ii       , Uu^Ii       , Uu^Ii       , Xu          , Xu          , Xu          , Xu          , Xu          , Xu          , Xu          
Xu          , Xu          , Xu          , Xu          , Xu          , Xu          , Xu          , Xu          , Xu          , Uu^Ii       , Uu^Ii       , Uu^Ii       , Uu^Ii       , Xu          , Xu          , Xu          , Xu          , Xu          , Xu          , Xu          
