border_size=1
usage=map

Xos         , Xos         , Xos         , Xos         , Xos         , Xos         , Xos         , Xos         , Cv          , Rp          , Rp          , Rp          , Rp          , Rp          , Rp          , Rp          , Cv          , Xos         , Xos         , Xos         , Xos         , Xos         
Xos         , Xos         , Xos         , Xos         , Xos         , Xos         , Xos         , Xos         , Cv          , Rp          , Rp          , Rp          , Rp          , Rp          , Rp          , Rp          , Cv          , Xos         , Xos         , Xos         , Xos         , Xos         
Xos         , Xos         , Xos         , Xos         , Xos         , Xos         , Xos         , Xos         , Cv          , Rp          , Rp          , Rp          , Gg^Fet      , Rp          , Rp          , Rp          , Cv          , Xos         , Xos         , Xos         , Xos         , Xos         
Cv          , Cv          , Cv          , Cv          , Cv          , Cv          , Cv          , Cv          , Rp          , Rp          , Gs^Fp       , Rp          , Rp          , Rp          , Gs^Fp       , Rp          , Rp          , Cv          , Cv          , Cv          , Cv          , Cv          
Rp          , Rp          , Rp          , Rp          , Rp          , Rp          , Rp          , Rp          , Gs^Fp       , Gs^Fp       , Rp          , Ch          , 5 Kh        , Ch          , Rp          , Gs^Fp       , Gs^Fp       , Rp          , Rp          , Rp          , Rp          , Rp          
Wwf         , Rp          , Wwf         , Rp          , Wwf         , Gg^Fet      , Wwf         , Gs^Fp       , Rp          , Rp          , 2 Ch        , Ch          , Wwf         , Ch          , 6 Ch        , Rp          , Rp          , Gs^Fp       , Wwf         , Gg^Fet      , Wwf         , Rp          
Rp          , Wwf         , Rp          , Wwf         , Rp          , Wwf         , Rp          , Wwf         , Ch          , Ch          , Ggf         , Wwf         , Ww          , Wwf         , Ggf         , Ch          , Ch          , Wwf         , Rp          , Wwf         , Rp          , Wwf         
Rp          , Rp          , Rp          , Rp          , Rp          , Rp          , Rp          , Rp          , Ch          , 1 Kh        , Ggf         , Wwf         , Ww          , Wwf         , Ggf         , 8 Kh        , Ch          , Rp          , Rp          , Rp          , Rp          , Rp          
Wwf         , Wwf         , Wwf         , Wwf         , Wwf         , Wwf         , Wwf         , Wwf         , Rp          , Ch          , 3 Ch        , Wwf         , Wwf         , Wwf         , 7 Ch        , Ch          , Rp          , Wwf         , Wwf         , Wwf         , Wwf         , Wwf         
Rp          , Rp          , Rp          , Rp          , Rp          , Gg^Fet      , Rp          , Gs^Fp       , Gs^Fp       , Rp          , Rp          , Ch          , 4 Kh        , Ch          , Rp          , Rp          , Gs^Fp       , Gs^Fp       , Rp          , Gg^Fet      , Rp          , Rp          
Rp          , Rp          , Rp          , Rp          , Rp          , Rp          , Rp          , Rp          , Rp          , Gs^Fp       , Gs^Fp       , Ch          , Rp          , Ch          , Gs^Fp       , Gs^Fp       , Rp          , Rp          , Rp          , Rp          , Rp          , Rp          
Cv          , Cv          , Cv          , Cv          , Cv          , Cv          , Cv          , Cv          , Cv          , Rp          , Rp          , Rp          , Gg^Fet      , Rp          , Rp          , Rp          , Cv          , Cv          , Cv          , Cv          , Cv          , Cv          
Xos         , Xos         , Xos         , Xos         , Xos         , Xos         , Xos         , Xos         , Xos         , Cv          , Rp          , Rp          , Rp          , Rp          , Rp          , Cv          , Xos         , Xos         , Xos         , Xos         , Xos         , Xos         
Xos         , Xos         , Xos         , Xos         , Xos         , Xos         , Xos         , Xos         , Xos         , Cv          , Rp          , Rp          , Rp          , Rp          , Rp          , Cv          , Xos         , Xos         , Xos         , Xos         , Xos         , Xos         
