border_size=1
usage=map

Md^Xm       , Md^Xm       , Md^Xm       , Md          , Md          , Md          , Hd          , Dd          , Rd          , Dd          , Hd          , Md          , Md          , Md          , Md          , Md^Xm       , Md^Xm       , Md^Xm       , Md^Xm       , Md^Xm       , Md^Xm       , Md          
Md^Xm       , Md^Xm       , Md^Xm       , Md          , Md          , Md          , Hd          , Dd          , Rd          , Dd          , Dd          , Hd          , Hd          , Md          , Md          , Md^Xm       , Md^Xm       , Md^Xm       , Md^Xm       , Md^Xm       , Md^Xm       , Md^Xm       
Md^Xm       , Md^Xm       , Md^Xm       , Md          , Md          , Md          , Hd          , Dd          , Dd          , Ds          , Dd          , Hd          , Hd          , Md          , Md          , Md          , Md^Xm       , Md^Xm       , Md^Xm       , Md^Xm       , Md^Xm       , Md^Xm       
Md^Xm       , Md^Xm       , Md^Xm       , Md          , Md          , Md          , Hd          , Dd          , Dd          , Rd          , Rd          , Hd          , Hd          , Hd          , Md          , Md          , Md^Xm       , Md^Xm       , Md^Xm       , Md^Xm       , Md^Xm       , Md^Xm       
Md^Xm       , Md^Xm       , Md^Xm       , Md^Xm       , Md^Xm       , Md          , Md          , Hd          , Dd          , Dd          , Rd          , Dd          , Dd          , Hd          , Hd          , Md          , Md          , Md^Xm       , Md          , Md^Xm       , Md^Xm       , Md^Xm       
Md^Xm       , Md^Xm       , Md          , Md^Xm       , Md^Xm       , Md          , Md          , Hd          , Hd          , Dd          , Ds          , Dd          , Dd          , Dd          , Hd          , Hd          , Md          , Md          , Md          , Md^Xm       , Md^Xm       , Md^Xm       
Hd          , Md          , Hd          , Md          , Hd          , Md          , Hd          , Hd          , Hd          , Dd          , Dd          , Rd          , Gs          , Dd          , Ds          , Hd          , Ds          , Md          , Md          , Md^Xm       , Md^Xm       , Md^Xm       
Gs          , Gs          , Gs          , Hd          , Gs          , Hd          , Gs          , Ds          , Gs          , Ds          , Gs          , Gs          , Gs          , Gs          , Gs          , Ds          , Ds          , Hd          , Hd          , Md          , Md^Xm       , Md^Xm       
Ww          , Gs          , Ww          , Gs          , Wwf         , Gs          , Ww          , Hh          , Wwf         , Gs          , Ww          , Wwf         , Wwf         , Ww          , Wwf         , Gs          , Hd          , Hd          , Hd          , Md          , Md^Xm       , Md^Xm       
Ww          , Ww          , Ww          , Ww          , Wwf         , Wwf         , Ww          , Ww          , Ww          , Ww          , Md          , Wwf         , Ce          , Ce          , Wwf         , Gs          , Hd          , Hd          , Md          , Md          , Md^Xm       , Md^Xm       
Md          , Md          , Md          , Hd          , Md          , Hd          , Md          , Hd          , Md          , Hd          , Gs          , Ce          , 1 Ke        , Ce          , Ww          , Wwf         , Wwf         , Hd          , Gs          , Gs          , Gs          , Md          
Md^Xm       , Md^Xm       , Md^Xm       , Md^Xm       , Md^Xm       , Md^Xm       , Md^Xm       , Md          , Hd          , Ds          , Gs          , Ce          , Ce          , Ce          , Ww          , Wwf         , Wwf         , Ww          , Ww          , Wwf         , Ww          , Wwf         
Md^Xm       , Md^Xm       , Md^Xm       , Md^Xm       , Md^Xm       , Md^Xm       , Md          , Md          , Hd          , Ds          , Gs          , Gs          , Ce          , Wwf         , Wwf         , Wwf         , Gs          , Wwf         , Wwf         , Wwf         , Ww          , Ww          
Md^Xm       , Md^Xm       , Md          , Md          , Md          , Md          , Hd          , Hd          , Ds          , Ds          , Rd          , Rd          , Gs          , Ce          , Gs          , Gs          , Md          , Gs          , Md          , Gs          , Md^Xm       , Md^Xm       
Md          , Md          , Md          , Md          , Md          , Md          , Hd          , Hd          , Hd          , Ds          , Rd          , Dd          , Gs          , Gs          , Hd          , Md          , Md          , Md          , Md^Xm       , Md^Xm       , Md^Xm       , Md^Xm       
Md          , Md          , Hd          , Md          , Dd          , Hd          , Ds          , Ds          , Rd          , Ds          , Dd          , Dd          , Hd          , Hd          , Hd          , Md          , Md          , Md          , Md^Xm       , Md^Xm       , Md^Xm       , Md^Xm       
Hd          , Hd          , Hd          , Ds          , Dd          , Ds          , Ds          , Rd          , Dd          , Dd          , Hd          , Dd          , Ce          , Hd          , Md          , Md          , Md          , Md          , Md^Xm       , Md^Xm       , Md^Xm       , Md^Xm       
Hd          , Hd          , Ds          , Dd          , Rd          , Dd          , Dd          , Hd          , Dd          , Hd          , Md          , Ce          , 2 Ke        , Ce          , Md          , Md          , Md          , Md          , Md^Xm       , Md^Xm       , Md^Xm       , Md          
Hd          , Hd          , Ds          , Dd          , Rd          , Dd          , Dd          , Dd          , Ds          , Md          , Md          , Ce          , Ce          , Ce          , Md          , Md          , Md^Xm       , Md          , Md^Xm       , Md^Xm       , Md^Xm       , Md^Xm       
Hd          , Ds          , Ds          , Rd          , Ds          , Hd          , Dd          , Dd          , Md          , Md          , Md          , Md          , Md          , Md          , Md^Xm       , Md^Xm       , Md^Xm       , Md^Xm       , Md^Xm       , Md^Xm       , Md^Xm       , Md^Xm       
Rd          , Rd          , Md          , Md          , Md          , Md          , Dd          , Ds          , Md^Xm       , Md^Xm       , Md^Xm       , Md^Xm       , Md^Xm       , Md^Xm       , Md^Xm       , Md^Xm       , Md^Xm       , Md^Xm       , Md^Xm       , Md^Xm       , Md^Xm       , Md^Xm       
Md          , Md          , Md          , Md          , Md          , Md          , Md          , Md          , Md^Xm       , Md^Xm       , Md^Xm       , Md^Xm       , Md^Xm       , Md^Xm       , Md^Xm       , Md^Xm       , Md^Xm       , Md^Xm       , Md^Xm       , Md^Xm       , Md^Xm       , Md^Xm       
