border_size=1
usage=map

Yr          , Uu          , Uu          , Ryd         , Yr          , Yr          , Uu          , Uu          , Uu          , Yr          , Ryd         , Yr          , Yr^Xp         , Yr          , Ryd         , Ryd         , Yr          , Yr          , Ryd         , Yr          , Ryd         , Ryd         , Ryd         , Ryd         , Ryd         , Yr          , Ryd         , Ryd         , Yr          , Ryd         , Yr          , Ryd         , Ryd         , Ryd         , Ryd         , Ryd         , Yr          , Ryd         , Yr^Xp         , Ryd         , Yr^Xp         , Yr
Ryd         , Yr          , Ryd         , Yr          , Yr          , Yr^Xp         , Yr          , Uu          , Ryd         , Yr          , Yr          , Yr          , Ryd         , Yr          , Yl          , Ryd         , Yr^Xp         , Ryd         , Ryd         , Yr          , Ryd         , Yr          , Yr^Xp         , Ryd         , Ryd         , Yr          , Ryd         , Ryd         , Yr          , Ryd         , Ryd         , Yl          , Ryd         , Yr          , Ryd         , Ryd         , Ryd         , Ryd         , Ryd         , Ryd         , Yr          , Yr
Yr          , Ryd         , Ryd         , Ryd         , Ryd         , Yr          , Ryd         , Ryd         , Yr          , Ryd         , Ryd         , Ryd         , Yr          , Ryd         , Yl          , Yl          , Ryd         , Yr          , Ryd         , Yr          , Ryd         , Yr          , Yr          , Yr          , Yr          , Yr          , Ryd         , Yr^Xp         , Ryd         , Yr          , Ryd         , Ryd         , Ryd         , Ryd         , Yr          , Yr          , Yr          , Ryd         , Yr          , Yl          , Ryd         , Ryd
Yr^Xp         , Ryd         , Yr          , Ryd         , Yr          , Ryd         , Ryd         , Uu          , Uu          , Yr^Xp         , Ryd         , Ryd         , Yl          , Yr          , Yl          , Yr          , Yr          , Ryd         , Yr          , Yr          , Yr          , Yr          , Yl          , Yr          , Ryd         , Yr          , Ryd         , Ryd         , Yr          , Ryd         , Ryd         , Yl          , Yl          , Ryd         , Ryd         , Yr^Xp         , Yr          , Yr          , Uu          , Ryd         , Ryd         , Yr
Yr          , Ryd         , Ryd         , Yr^Xp         , Ryd         , Ryd         , Ryd         , Uu          , Yl          , Yl          , Ryd         , Yr          , Ryd         , Yl          , Yl          , Ryd         , Yr          , Yr^Xp         , Ryd         , Ryd         , Yr^Xp         , Yr          , Yr          , Yl          , Ryd         , Yr^Xp         , Ryd         , Ryd         , Yr          , Uu          , Uu          , Yr          , Yr          , Yr          , Ryd         , Yr          , Yr          , Uu          , Uu          , Yr^Xp         , Ryd         , Yr
Yr          , Yl          , Yl          , Yr          , Ryd         , Yr^Xp         , Yr          , Yr          , Yl          , Yr          , Yr^Xp         , Yr          , Yr          , Yl          , Ryd         , Yr          , Yr          , Ryd         , Yr          , Yr          , Ryd         , Yr          , Ryd         , Ryd         , Ryd         , Yr          , Ryd         , Ryd         , Yr          , Uu          , Yl          , Yr          , Ryd         , Ryd         , Yr          , Ryd         , Yl          , Uu          , Yl          , Yr          , Ryd         , Yl
Ryd         , Yl          , Yr          , Yr          , Yr          , Ryd         , Ryd         , Yr          , Yl          , Yr          , Ryd         , Yr          , Uu          , Yl          , Ryd         , Yr          , Ryd         , Yl          , Yr          , Ryd         , Ryd         , Yr          , Yr          , Yr          , Ryd         , Ryd         , Yr          , Ryd         , Ryd         , Yr          , Ryd         , Ryd         , Ryd         , Ryd         , Yr          , Ryd         , Yr          , Uu          , Ryd         , Ryd         , Yr          , Ryd         
Ryd         , Yl          , Ryd         , Yr          , Ryd         , Yr          , Yr          , Ryd         , Yl          , Yl          , Ryd         , Uu          , Uu          , Uu          , Yr^Xp         , Yr          , Ryd         , Yr          , Ryd         , Ryd         , Yr^Xp         , Ryd         , Ryd         , Ryd         , Ryd         , Yl          , Yr          , Yr          , Ryd         , Yl          , Yr          , Ryd         , Ryd         , Yr          , Ryd         , Yl          , Yr          , Yr          , Yl          , Ryd         , Yr          , Yr
Yr          , Yl          , Ryd         , Yr          , Yr          , Ryd         , Yr          , Yr          , Yr^Xp         , Ryd         , Ryd         , Yr          , Ryd         , Ryd         , Ryd         , Ryd         , Yr          , Ryd         , Ryd         , Ryd         , Yr          , Ryd         , Ryd         , Ryd         , Yr          , Ryd         , Yr          , Yr^Xp         , Ryd         , Yr^Xp         , Ryd         , Yr          , Yr          , Ryd         , Yr          , Yl          , Yr          , Yr          , Ryd         , Yr          , Ryd         , Ryd
Yr          , Ryd         , Yr^Xp         , Ryd         , Uu          , Ryd         , Uu          , Yr          , Yr          , Yr          , Yr          , Yr          , Ryd         , Ryd         , Ryd         , Yr          , Ryd         , Yr^Xp         , Yr          , Ryd         , Ryd         , Ryd         , Yr          , Ryd         , Ryd         , Ryd         , Ryd         , Yr          , Ryd         , Yr          , Yr          , Yr          , Yr          , Yl          , Ryd         , Ryd         , Ryd         , Ryd         , Yr          , Ryd         , Ryd         , Ryd
Ryd         , Ryd         , Ryd         , Yr          , Uu          , Uu          , Yr          , Yr          , Yr          , Yl          , Uu          , Ryd         , Yr          , Ryd         , Yr          , Ryd         , Yr          , Ryd         , Ryd         , Yl          , Ryd         , Yr^Xp         , Ryd         , Yr          , Yr          , Ryd         , Ryd         , Ryd         , Yr          , Yr          , Ryd         , Ryd         , Yr^Xp         , Ryd         , Ryd         , Ryd         , Yr          , Yr^Xp         , Yl          , Ryd         , Yl          , Yr
Ryd         , Ryd         , Ryd         , Yr          , Ryd         , Yr          , Yr          , Yr^Xp         , Yr          , Uu          , Uu          , Ryd         , Yr^Xp         , Yr          , Ryd         , Ryd         , Yr^Xp         , Ryd         , Ryd         , Yr          , Yr          , Yr          , Yr          , Ryd         , Yr          , Yr^Xp         , Yr          , Ryd         , Ryd         , Yr          , Ryd         , Yr          , Ryd         , Yl          , Yl          , Ryd         , Yr          , Yr          , Ryd         , Yl          , Yr^Xp         , Yr
Yr          , Ryd         , Yr          , Yl          , Yl          , Ryd         , Yr          , Ryd         , Yr          , Ryd         , Ryd         , Yr          , Yr          , Ryd         , Ryd         , Yr          , Yl          , Yr          , Ryd         , Yr          , Ryd         , 1 Yr        , Ryd         , Ryd         , Ryd         , Ryd         , Yl          , Ryd         , Yr          , Ryd         , Yr          , Yr          , Ryd         , Yl          , Yr          , Ryd         , Ryd         , Ryd         , Ryd         , Yr          , Ryd         , Yr          
Ryd         , Yr          , Ryd         , Yr          , Ryd         , Ryd         , Yl          , Yl          , Yr          , Ryd         , Ryd         , Yr          , Yr          , Yl          , Ryd         , Ryd         , Ryd         , Ryd         , Yr          , Yr          , Ryd         , Ryd         , Yr          , Yr^Xp         , Ryd         , Yr          , Yr          , Yr          , Ryd         , Yr          , Ryd         , Ryd         , Ryd         , Yr          , Uu          , Ryd         , Yr          , Yr          , Yl          , Ryd         , Ryd         , Ryd
Ryd         , Ryd         , Ryd         , Yr^Xp         , Yr          , Ryd         , Yr          , Yr          , Yr          , Ryd         , Uu          , Ryd         , Yr          , Uu          , Uu          , Uu          , Ryd         , Yl          , Yr          , Ryd         , Yr          , Yl          , Yr          , Yr          , Yr          , Ryd         , Ryd         , Ryd         , Yr          , Yl          , Ryd         , Ryd         , Yr          , Yr^Xp         , Yr          , Uu          , Yr          , Ryd         , Ryd         , Ryd         , Yr^Xp         , Ryd
Ryd         , Ryd         , Ryd         , Ryd         , Yr          , Ryd         , Yr          , Yr^Xp         , Uu          , Uu          , Uu          , Uu          , Uu          , Uu          , Uu          , Yr          , Yr          , Yr          , Ryd         , Ryd         , Ryd         , Ryd         , Ryd         , Yl          , Ryd         , Yl          , Ryd         , Ryd         , Ryd         , Yr          , Yr          , Ryd         , Ryd         , Ryd         , Ryd         , Uu          , Uu          , Yl          , Yr          , Yl          , Ryd         , Ryd
Yr          , Ryd         , Ryd         , Yr          , Yr          , Ryd         , Ryd         , Yr          , Uu          , Uu          , Ryd         , Uu          , Uu          , Yr^Xp         , Ryd         , Ryd         , Yr^Xp         , Ryd         , Yr          , Yr          , Ryd         , Ryd         , Ryd         , Yr          , Ryd         , Yr          , Yr          , Ryd         , Yr          , Yr          , Yr          , Yr          , Yr          , Ryd         , Ryd         , Uu          , Uu          , Uu          , Yr          , Yr          , Ryd         , Ryd
Ryd         , Yr          , Ryd         , Ryd         , Yl          , Yr          , Yr          , Ryd         , Ryd         , Ryd         , Ryd         , Yr          , Yr          , Ryd         , Yr          , Ryd         , Ryd         , Ryd         , Ryd         , Ryd         , Yr          , Yr          , Ryd         , Yr          , Yr          , Uu          , Uu          , Yr          , Yr          , Yr^Xp         , Uu          , Yr          , Ryd         , Yl          , Ryd         , Uu          , Uu          , Ryd         , Ryd         , Yr          , Ryd         , Ryd
Ryd         , Ryd         , Ryd         , Yr          , Uu          , Uu          , Yr          , Ryd         , Ryd         , Yr          , Ryd         , Ryd         , Ryd         , Yl          , Yr          , Yl          , Ryd         , Ryd         , Ryd         , Ryd         , Ryd         , Ryd         , Yl          , Yr          , Ryd         , Yr          , Uu          , Yr          , Ryd         , Uu          , Uu          , Uu          , Uu          , Yr          , Ryd         , Yr          , Yr          , Yl          , Ryd         , Yr          , Ryd         , Ryd         
Ryd         , Ryd         , Yr          , Uu          , Ryd         , Uu          , Yr          , Ryd         , Yr          , Yr^Xp         , Ryd         , Ryd         , Ryd         , Yr          , Yr^Xp         , Yr          , Yr          , Yr          , Ryd         , Ryd         , Ryd         , Yr          , Yr          , Yr          , Ryd         , Yr          , Yr          , Uu          , Ryd         , Uu          , Yr^Xp         , Ryd         , Ryd         , Ryd         , Yr          , Ryd         , Ryd         , Yr          , Yr          , Yr          , Ryd         , Ryd
Yr          , Yr          , Ryd         , Ryd         , Yr          , Yl          , Yr          , Yr          , Ryd         , Ryd         , Ryd         , Ryd         , Yr          , Yr          , Uu          , Ryd         , Ryd         , Ryd         , Yr          , Yl          , Yr          , Ryd         , Ryd         , Ryd         , Yl          , Yr          , Yr^Xp         , Ryd         , Yl          , Yr          , Ryd         , Ryd         , Ryd         , Ryd         , Yr          , Yr          , Ryd         , Yr          , Yr          , Yr^Xp         , Yr          , Yl
Yr^Xp         , Ryd         , Yr          , Ryd         , Ryd         , Yr^Xp         , Ryd         , Ryd         , Yr          , Ryd         , Yr          , Ryd         , Ryd         , Uu          , Uu          , Uu          , Ryd         , Ryd         , Ryd         , Yr^Xp         , Yr^Xp         , Ryd         , Ryd         , Ryd         , Ryd         , Yr          , Yr          , Yr          , Ryd         , Yr          , Ryd         , Ryd         , Yr          , Yr^Xp         , Uu          , Ryd         , Ryd         , Yr          , Yr          , Ryd         , Ryd         , Yr
Yr          , Yr          , Ryd         , Ryd         , Yr          , Yr          , Ryd         , Ryd         , Ryd         , Yr^Xp         , Yr          , Ryd         , Ryd         , Ryd         , Ryd         , Yr          , Yr          , Yl          , Yr          , Ryd         , Yr^Xp         , 3 Yr        , Ryd         , Yl          , Yr          , Yr          , Ryd         , Ryd         , Ryd         , Yr          , Ryd         , Ryd         , Uu          , Uu          , Ryd         , Yl          , Yr^Xp         , Ryd         , Ryd         , Ryd         , Yr          , Yr
Ryd         , Ryd         , Ryd         , Ryd         , Ryd         , Ryd         , Ryd         , Yr          , Yr          , Yr          , Ryd         , Ryd         , Yr          , Ryd         , Ryd         , Ryd         , Ryd         , Yr          , Ryd         , Ryd         , Ryd         , Ryd         , Yr          , Yl          , Ryd         , Yr          , Yr          , Ryd         , Ryd         , Yr          , Yr^Xp         , Yr          , Ryd         , Uu          , Yr          , Yr          , Yr          , Yr          , Yr          , Ryd         , Ryd         , Ryd
Yr          , Yr          , Ryd         , Yl          , Yr^Xp         , Ryd         , Ryd         , Yr          , Ryd         , Yr          , Ryd         , Ryd         , Yl          , Yl          , Ryd         , Ryd         , Yr^Xp         , Yl          , Ryd         , Ryd         , Ryd         , Ryd         , Ryd         , Yl          , Yl          , Ryd         , Ryd         , Ryd         , Yl          , Yr          , Ryd         , Ryd         , Ryd         , Ryd         , Ryd         , Ryd         , Ryd         , Yr^Xp         , Ryd         , Ryd         , Ryd         , Ryd
Yr          , Ryd         , Ryd         , Yr          , Yr          , Ryd         , Yr          , Yr          , Ryd         , Ryd         , Yr^Xp         , Yr          , Yr          , Yl          , Ryd         , Yr          , Yr          , Ryd         , Yr          , Yr          , Ryd         , Yr          , Yr          , Yr^Xp         , Yr          , Yl          , Ryd         , Ryd         , Ryd         , Yr          , Yr          , Ryd         , Yr^Xp         , Ryd         , Yr          , Ryd         , Ryd         , Ryd         , Yl          , Yr          , Ryd         , Ryd
Yr          , Yr^Xp         , Ryd         , Ryd         , Ryd         , Ryd         , Yr          , Ryd         , Yr          , Yr          , Yr          , Yr          , Yl          , Ryd         , Ryd         , Yl          , Ryd         , Ryd         , Ryd         , Ryd         , Yl          , Ryd         , Ryd         , Ryd         , Ryd         , Yr          , Yr          , Ryd         , Ryd         , Yr          , Yr          , Ryd         , Ryd         , Uu          , Uu          , Ryd         , Yr          , Yr          , Yr          , Ryd         , Ryd         , Ryd
Yr          , Yr          , Yr          , Yl          , Uu          , Uu          , Yr          , Ryd         , Yr          , Yl          , Yr          , Yr^Xp         , Uu          , Uu          , Ryd         , Ryd         , Yr          , Yl          , Ryd         , Ryd         , Yr          , Ryd         , Ryd         , Yr          , Yr          , Yr^Xp         , Ryd         , Yr          , Ryd         , Ryd         , Yl          , Yr^Xp         , Uu          , Uu          , Uu          , Ryd         , Yr          , Yr^Xp         , Ryd         , Yr^Xp         , Yr          , Ryd
Ryd         , Ryd         , Ryd         , Yr          , Yr          , Uu          , Yr^Xp         , Yr          , Yr          , Ryd         , Ryd         , Ryd         , Uu          , Uu          , Ryd         , Yr          , Yr          , Yr^Xp         , Yr          , Yr          , Yl          , Yr          , Yr          , Ryd         , Yr          , Yr          , Ryd         , Ryd         , Ryd         , Yr          , Ryd         , Yr          , Yr          , Uu          , Uu          , Yr          , Yr^Xp         , Yr          , Ryd         , Yr          , Yl          , Ryd
Ryd         , Ryd         , Ryd         , Ryd         , Ryd         , Yr          , Yr          , Ryd         , Ryd         , Ryd         , Ryd         , Yr          , Uu          , Ryd         , Yr          , Yl          , Ryd         , Yr          , Yr          , Ryd         , Ryd         , Uu          , Uu          , Yl          , Yr          , Ryd         , Yl          , Ryd         , Ryd         , Yr          , Ryd         , Ryd         , Ryd         , Yr          , Uu          , Yr          , Yr^Xp         , Ryd         , Yr          , Ryd         , Ryd         , Ryd
Ryd         , Yr          , Ryd         , Uu          , Uu          , Yr          , Yr          , Ryd         , Yr^Xp         , Ryd         , Ryd         , Yr          , Ryd         , Ryd         , Yl          , Yl          , Yr          , Yl          , Ryd         , Ryd         , Uu          , Uu          , Yr^Xp         , Yr          , Ryd         , Ryd         , Ryd         , Ryd         , Ryd         , Ryd         , Ryd         , Ryd         , Ryd         , Yr          , Uu          , Yr          , Ryd         , Yr^Xp         , Ryd         , Ryd         , Yr^Xp         , Ryd
Yr          , Yr^Xp         , Ryd         , Yr          , Uu          , Uu          , Yr          , Yr          , Yr          , Ryd         , Ryd         , Yr          , Ryd         , Ryd         , Ryd         , Yl          , Yr          , Yr          , Yr          , Ryd         , Ryd         , Yr          , Yr          , Ryd         , Yr          , Yr          , Yr          , Ryd         , Ryd         , Yr          , Ryd         , Ryd         , Yr^Xp         , Ryd         , Yr          , Yr          , Ryd         , Yr          , Ryd         , Yl          , Yr          , Yr
Yr          , Ryd         , Yr          , Yr          , Yr          , Uu          , Yr          , Ryd         , Ryd         , Yr          , Yr          , Yr          , Ryd         , Ryd         , Yr          , Ryd         , Ryd         , Ryd         , Yr          , Ryd         , Ryd         , Yr          , Ryd         , Ryd         , Ryd         , Ryd         , Ryd         , Ryd         , Ryd         , Yr          , Yl          , Yr          , Ryd         , Yr          , Ryd         , Ryd         , Yr          , Yr          , Ryd         , Ryd         , Ryd         , Ryd         
Ryd         , Ryd         , Ryd         , Ryd         , Yr          , Ryd         , Yr^Xp         , Ryd         , Ryd         , Ryd         , Yr          , Ryd         , Yr          , Yr          , Ryd         , Ryd         , Yr          , Yr^Xp         , Ryd         , Ryd         , Ryd         , Ryd         , Ryd         , Yr^Xp         , Yr^Xp         , Ryd         , Yr          , Ryd         , Yl          , Yr          , Ryd         , Ryd         , Ryd         , Yr          , Ryd         , Ryd         , Yr          , Uu          , Uu          , Ryd         , Yr^Xp         , Ryd
Ryd         , Ryd         , Yr          , Uu          , Ryd         , Ryd         , Ryd         , Ryd         , Yr          , Yr          , Yr^Xp         , Yr^Xp         , Yr          , Uu          , Uu          , Ryd         , Yr          , Yr          , Yr          , Ryd         , Yr          , Yr          , Ryd         , Ryd         , Ryd         , Yr^Xp         , Ryd         , Yr^Xp         , Yr          , Yr          , Yr          , Yr          , Yr          , Yr          , Yr          , Ryd         , Ryd         , Yr          , Uu          , Yr          , Yr          , Ryd
Yr          , Yl          , Uu          , Uu          , Uu          , Yr          , Ryd         , Ryd         , Ryd         , Yl          , Ryd         , Yr          , Yr          , Uu          , Uu          , Yr          , Uu          , Ryd         , Yr          , Yr          , Yr          , Yr^Xp         , Yr          , Yr          , Yr          , Ryd         , Yr          , Yr          , Yr          , Yl          , Yr^Xp         , Uu          , Yr          , Ryd         , Ryd         , Ryd         , Ryd         , Ryd         , Uu          , Uu          , Yr^Xp         , Ryd
Yr^Xp         , Yr          , Uu          , Uu          , Ryd         , Ryd         , Ryd         , Ryd         , Yr          , Ryd         , Ryd         , Yr          , Ryd         , Ryd         , Yl          , Yr          , Yr^Xp         , Uu          , Ryd         , Yl          , Yr          , Ryd         , Yr          , Ryd         , Ryd         , Ryd         , Yr          , Yr          , Ryd         , Yr          , Uu          , Uu          , Yr          , Yr          , Yr^Xp         , Yl          , Yr          , Ryd         , Ryd         , Uu          , Yl          , Ryd
Ryd         , Yr          , Yr          , Uu          , Yr^Xp         , Yr          , Yr          , Ryd         , Yl          , Ryd         , Yr          , Ryd         , Ryd         , Yr          , Yr^Xp         , Yr          , Ryd         , Uu          , Ryd         , Ryd         , Yr          , Ryd         , Ryd         , Ryd         , Ryd         , Ryd         , Yr          , Ryd         , Ryd         , Yr^Xp         , Yr          , Uu          , Uu          , Yr          , Yr          , Yr          , Yr          , Yr          , Ryd         , Yr          , Yr          , Yr
Ryd         , Ryd         , Ryd         , Ryd         , Yl          , Uu          , Uu          , Yr          , Ryd         , Yr          , Ryd         , Ryd         , Ryd         , Ryd         , Yr          , Ryd         , Yr          , Ryd         , Ryd         , Ryd         , Ryd         , Ryd         , Yr          , Yr          , Yr          , Ryd         , Ryd         , Yr^Xp         , Ryd         , Ryd         , Yr^Xp         , Uu          , Uu          , Uu          , Ryd         , Ryd         , Yr          , Yr^Xp         , Ryd         , Ryd         , Ryd         , Ryd
Yr          , Ryd         , Yr^Xp         , Ryd         , Yr          , Uu          , Yr          , Ryd         , Ryd         , Ryd         , Yr^Xp         , Ryd         , Ryd         , Yr          , Ryd         , Ryd         , Yl          , Yr^Xp         , Yr          , Yr          , Ryd         , Ryd         , Yr          , Yl          , Ryd         , Ryd         , Yr          , Ryd         , Ryd         , Ryd         , Ryd         , Uu          , Uu          , Uu          , Yr          , Yr          , Yr^Xp         , Yr          , Yl          , Yr          , Ryd         , Yr
Ryd         , Yr          , Yr          , Ryd         , Yr          , Ryd         , Ryd         , Ryd         , Yr          , Ryd         , Yr          , Yr          , Yr^Xp         , Ryd         , Ryd         , Ryd         , Ryd         , Ryd         , Ryd         , Ryd         , Ryd         , Ryd         , Yr          , Ryd         , Ryd         , Ryd         , Yl          , Ryd         , Yr^Xp         , Ryd         , Ryd         , Yr^Xp         , Yr          , Ryd         , Yr          , Ryd         , Yr          , Yr          , Yr          , Yr^Xp         , Yr          , Ryd
Yr          , Ryd         , Ryd         , Yr          , Yr          , Ryd         , Ryd         , Yr          , Ryd         , Ryd         , Ryd         , Yl          , Yr          , Yr          , Ryd         , Ryd         , Yr          , Yr          , Ryd         , Ryd         , Ryd         , Yr          , Ryd         , Yr          , Ryd         , Yr          , Yr          , Yr          , Yr          , Yr          , Yr          , Yr          , Ryd         , Yl          , Yr          , Yr          , Ryd         , Ryd         , Yr          , Ryd         , Ryd         , Ryd         
