border_size=1
usage=map

Qxs         , Qxs         , Qxs         , Qxs         , Qxs         , Qxs         , Qxs         , Qxs         , Qxs         , Qxs         , Qxs         , Qxs         , Qxs         , Qxs         , Qxs         , Qxs         , Qxs         
Qxs         , Qxs         , Qxs         , Qxs         , Qxs         , Qxs         , Qxs         , Qxs         , Qxs         , Qxs         , Qxs         , Qxs         , Qxs         , Qxs         , Qxs         , Qxs         , Qxs         
Qxs         , Qxs         , Qxs         , Qxs         , Qxs         , Qxs         , Qxs         , Qxs         , Qxs         , Qxs         , Qxs         , Qxs         , Qxs         , Qxs         , Qxs         , Qxs         , Qxs         
Qxs         , Qxs         , Qxs         , Qxs         , Qxs         , Qxs         , Qxs         , Qxs         , Uu^Fi       , Qxs         , Qxs         , Qxs         , Qxs         , Qxs         , Qxs         , Qxs         , Qxs         
Qxs         , Qxs         , Qxs         , Qxs         , Qxs         , Qxs         , Uu          , Uu          , Qxs         , Uu          , Uu          , Qxs         , Qxs         , Qxs         , Qxs         , Qxs         , Qxs         
Qxs         , Qxs         , Qxs         , Qxs         , Uu^Fi       , Uu          , Qxs         , Qxs         , Uu^Fi       , Qxs         , Qxs         , Uu          , Uu^Fi       , Qxs         , Qxs         , Qxs         , Qxs         
Qxs         , Qxs         , Qxs         , Qxs         , Uu          , Qxs         , Uu^Fi       , Uu          , Yr          , Uu          , Uu^Fi       , Qxs         , Uu          , Qxs         , Qxs         , Qxs         , Qxs         
Qxs         , Qxs         , Qxs         , Qxs         , Uu          , Qxs         , Uu          , Yr          , Yr          , Yr          , Uu          , Qxs         , Uu          , Qxs         , Qxs         , Qxs         , Qxs         
Qxs         , Qxs         , Qxs         , Qxs         , Uu          , Qxs         , Uu          , Yr          , 1 Yr        , Yr          , Uu          , Qxs         , Uu          , Qxs         , Qxs         , Qxs         , Qxs         
Qxs         , Qxs         , Qxs         , Qxs         , Uu          , Qxs         , Uu^Fi       , Yr          , Yr          , Yr          , Uu^Fi       , Qxs         , Uu          , Qxs         , Qxs         , Qxs         , Qxs         
Qxs         , Qxs         , Qxs         , Qxs         , Uu^Fi       , Qxs         , Qxs         , Uu          , Uu^Fi       , Uu          , Qxs         , Qxs         , Uu^Fi       , Qxs         , Qxs         , Qxs         , Qxs         
Qxs         , Qxs         , Qxs         , Qxs         , Qxs         , Uu          , Uu          , Qxs         , Qxs         , Qxs         , Uu          , Uu          , Qxs         , Qxs         , Qxs         , Qxs         , Qxs         
Qxs         , Qxs         , Qxs         , Qxs         , Qxs         , Qxs         , Qxs         , Uu          , Uu^Fi       , Uu          , Qxs         , Qxs         , Qxs         , Qxs         , Qxs         , Qxs         , Qxs         
Qxs         , Qxs         , Qxs         , Qxs         , Qxs         , Qxs         , Qxs         , Qxs         , Qxs         , Qxs         , Qxs         , Qxs         , Qxs         , Qxs         , Qxs         , Qxs         , Qxs         
Qxs         , Qxs         , Qxs         , Qxs         , Qxs         , Qxs         , Qxs         , Qxs         , Qxs         , Qxs         , Qxs         , Qxs         , Qxs         , Qxs         , Qxs         , Qxs         , Qxs         
Qxs         , Qxs         , Qxs         , Qxs         , Qxs         , Qxs         , Qxs         , Qxs         , Qxs         , Qxs         , Qxs         , Qxs         , Qxs         , Qxs         , Qxs         , Qxs         , Qxs         
Qxs         , Qxs         , Qxs         , Qxs         , Qxs         , Qxs         , Qxs         , Qxs         , Qxs         , Qxs         , Qxs         , Qxs         , Qxs         , Qxs         , Qxs         , Qxs         , Qxs         
