border_size=1
usage=map

Mm^Xm       , Mm^Xm       , Mm^Xm       , Mm          , Mm          , Mm          , Hh          , Hh          , Hh          , Hh          , Gs^Fp       , Gs^Ft       , Gs^Fp       , Gs^Fp       , Rp          , Gs^Fp       , Ggf         , Gs^Fp       , Ww          , Wo          , Wo          , Ww          , Gs^Fp       , Gg          , Gg          , Rp          , Gs^Fp       , Gs^Fp       , Gs^Fp       , Gs^Fp       , Hh          , Hh          , Mm^Xm       , Mm          , Mm          , Mm^Xm       , Mm^Xm       
Mm^Xm       , Mm^Xm       , Mm          , Mm          , Mm          , Mm          , Hh          , Hh          , Gs          , Hh          , Gg^Ve       , Gs^Ft       , Gg^Fet      , Rp          , Gg          , Gs^Fp       , Ww          , Ww          , Wo          , Wo          , Ww          , Ww          , Gs^Fp       , Gs^Fp       , Ggf         , Rp          , Gs^Ft       , Gs^Ft       , Gs^Fp       , Gs          , Gs^Fp       , Hh          , Mm          , Mm          , Mm^Xm       , Mm^Xm       , Mm          
Mm          , Mm          , Mm          , Hh          , Hh          , Hh          , Gs^Ft       , Gs^Ft       , Rp          , Gs          , Gs^Ft       , Gs^Ft       , Rp          , Rp          , Wwf         , Wwf         , Ww          , Wo          , Ww          , Ww          , Ww          , Gs^Ft       , Gs^Ft       , Gs^Ft       , Gs^Fp       , Rp          , Gs^Fp       , Gs^Ft       , Gs^Ft       , Gs^Fp       , Gs^Fp       , Hh          , Mm          , Mm          , Mm          , Mm^Xm       , Mm          
Mm          , Mm^Xm       , Mm          , Hh          , Gs^Ft       , Rp          , Rp          , Rp          , Gs^Fp       , Gs          , Gs^Ft       , Gs^Fp       , Rp          , Gs^Fp       , Ww          , Wwf         , Wwf         , Ww          , Gg^Fet      , Gs^Fp       , Gs^Fp       , Gs^Fp       , Gs^Fp       , Gs^Fp       , Gs^Fp       , Rp          , Gs^Fp       , Gs^Fp       , Gs^Ft       , Gs          , Gs          , Hh          , Hh          , Mm          , Mm          , Mm          , Mm^Xm       
Mm          , Mm          , Gs^Ft       , Hh          , Ggf         , Rp          , Gs^Fp       , Gg^Fet      , Gs^Fp       , Gs^Ft       , Rp          , Rp          , Wwf         , Wwf         , Ww          , Wwf         , Ggf         , Gg          , Gs^Fp       , Gs^Fp       , Gs^Fp       , Gs^Fp       , Gs^Fp       , Gg^Ve       , Gs^Fp       , Rp          , Gg^Fet      , Gs^Fp       , Gs^Fp       , Gs^Ft       , Gs^Ft       , Ggf         , Hh          , Hh          , Hh          , Mm          , Mm          
Hh          , Hh          , Gs^Ft       , Gs^Ft       , Gs^Ft       , Rp          , Gg          , Gs^Fp       , Gs^Ft       , Rp          , Gs^Fp       , Gg          , Ww          , Ww          , Wo          , Ww          , Ss          , Ggf         , Ggf         , Gs^Fp       , Gg          , Gs^Fp       , Ss          , Gs^Fp       , Rp          , Rp          , Gs          , Gs^Fp       , Ggf         , Gs^Ft       , Gs          , Gs^Fp       , Gs^Fp       , Gs^Fp       , Hh          , Mm          , Mm          
Hh          , Gs^Ft       , Ggf         , Gs^Fp       , Gs^Ft       , Gs^Ft       , Gg          , Gs^Fp       , Rp          , Rp          , Ww^Bw\      , Ww          , Ww          , Wo          , Ww          , Wo          , Wo          , Ss          , Ggf         , Wwf         , Cv          , Wwf         , Cv          , Gs^Fp       , Gs          , Gs^Fp       , Gs^Fp       , Gs^Fp       , Gs^Fp       , Gg          , Gs^Ft       , Gs^Fp       , Ggf         , Gs^Fp       , Hh          , Mm          , Mm          
Hh          , Hh          , Hh          , Gs^Fp       , Rp          , Rp          , Gg          , Rp          , Gg          , Gs^Fp       , Ww          , Ww^Bw\      , Rp          , Ww          , Gs^Fp       , Ww          , Ss          , Ww          , Ww          , Wwf         , Wwf         , Cv          , 2 Kv        , Cv          , Gs          , Gs^Fp       , Gs^Fp       , Gs^Fp       , Gs^Fp       , Gs^Fp       , Gs^Fp       , Gs^Ft       , Hh          , Hh          , Mm          , Mm          , Mm^Xm       
Gs^Fp       , Hh          , Gg^Fet      , Gg          , Gg^Ve       , Gs^Fp       , Gg          , Ggf         , Ww          , Ww          , Wo          , Ww          , Cv          , Gg^Ve       , Gg^Fet      , Gs^Fp       , Gs^Fp       , Ss          , Wwf         , Wwf         , Wwf         , Cv          , Cv          , Cv          , Cv          , Gg          , Gg^Ve       , Gs          , Gs^Fp       , Gs^Ft       , Gs^Ft       , Ggf         , Hh          , Mm          , Mm          , Mm          , Mm^Xm       
Gs^Fp       , Gs^Fp       , Rp          , Gs^Ft       , Gs^Ft       , Gs^Fp       , Gs^Fp       , Gs^Fp       , Ww          , Wo          , Wo          , Cv          , 1 Kv        , Cv          , Rp          , Gs^Ft       , Gs^Ft       , Gs^Fp       , Gg          , Ww          , Rp          , Cv          , Gg          , Rp          , Rp          , Gg          , Gg          , Gg          , Gs          , Gs^Fp       , Gs          , Gs^Ft       , Hh          , Hh          , Mm          , Mm^Xm       , Mm^Xm       
Gs^Fp       , Rp          , Gs^Fp       , Gs^Fp       , Gs^Ft       , Gs^Ft       , Gs^Fp       , Gs^Fp       , Ww          , Wo          , Ww          , Cv          , Cv          , Cv          , Cv          , Rp          , Rp          , Rp          , Rp          , Rp          , Gs^Fp       , Gs^Fp       , Gg^Ve       , Gs^Fp       , Rp          , Gs^Fp       , Gs^Ft       , Gg          , Gg          , Gs^Fp       , Gs^Fp       , Gs          , Hh          , Mm          , Mm          , Mm^Xm       , Mm^Xm       
Rp          , Rp          , Gs^Ft       , Gs^Ft       , Gs^Ft       , Gs^Ft       , Ww          , Ww          , Wo          , Wo          , Gg^Ve       , Rp          , Gg          , Gs^Fp       , Gs^Fp       , Gs^Fp       , Gs^Fp       , Gs^Ft       , Rp          , Gg          , Gs^Fp       , Gs^Fp       , Gs^Fp       , Gs^Ft       , Gs^Ft       , Rp          , Gs          , Gs^Ft       , Gs^Fp       , Gs^Fp       , Gs^Fp       , Hh          , Mm          , Mm^Xm       , Mm          , Mm^Xm       , Mm          
Hh          , Hh          , Hh          , Gs^Fp       , Ggf         , Gs^Fp       , Ww          , Wo          , Ww          , Ww          , Rp          , Rp          , Gs^Fp       , Gg          , Ggf         , Gg^Ve       , Gs^Fp       , Gs^Ft       , Gs^Fp       , Rp          , Gg          , Gs^Fp       , Gs^Ft       , Gs^Fp       , Gs^Fp       , Gs^Fp       , Rp          , Gs          , Gs^Fp       , Gs^Fp       , Hh          , Hh          , Mm          , Mm^Xm       , Mm          , Mm          , Mm          
Hh          , Gs^Fp       , Gs^Fp       , Gs^Fp       , Wwf         , Ww          , Wo          , Wo          , Gs^Fp       , Gs^Fp       , Rp          , Gs^Fp       , Ggf         , Gg          , Gs^Fp       , Gs          , Gs^Fp       , Gs^Fp       , Gs^Fp       , Rp          , Gg          , Gg          , Gg          , Gs^Ft       , Gs^Ft       , Gs^Fp       , Rp          , Gs^Fp       , Gg^Ve       , Gg^Fet      , Hh          , Mm          , Mm          , Hh          , Hh          , Mm          , Mm          
Hh          , Hh          , Ggf         , Gg          , Wwf         , Ww          , Ww          , Ww          , Gs^Ft       , Gs^Ft       , Rp          , Gg^Fet      , Gg          , Gg          , Gs          , Gs^Fp       , Gs^Fp       , Gs          , Gg          , Rp          , Rp          , Gs^Fp       , Gg^Ve       , Gs^Ft       , Ggf         , Gs^Fp       , Gs^Fp       , Gs^Fp       , Ggf         , Ggf         , Gg          , Mm          , Mm          , Mm          , Hh          , Mm          , Mm          
Hh          , Hh          , Wwf         , Wwf         , Wwf         , Wwf         , Ggf         , Gg^Ve       , Gs^Ft       , Gs^Ft       , Gs^Fp       , Gs^Fp       , Gs^Fp       , Gg          , Gs          , Gs^Ft       , Gs^Ft       , Gs          , Gs^Fp       , Gs^Fp       , Gs^Fp       , Rp          , Gs^Fp       , Gg^Fet      , Gs^Ft       , Gs^Ft       , Gs^Ft       , Rp          , Rp          , Hh          , Gs^Fp       , Gg          , Hh          , Hh          , Mm          , Mm          , Mm^Xm       
Ww          , Ww          , Ww          , Wwf         , Gg^Fet      , Gs^Fp       , Gs^Fp       , Gs^Fp       , Gs^Fp       , Gs^Fp       , Gs^Fp       , Rp          , Rp          , Gs          , Gs^Ft       , Gs^Ft       , Ww          , Ww          , Ww          , Gs^Fp       , Gs^Fp       , Rp          , Gs^Fp       , Gs^Ft       , Gs^Fp       , Gs^Fp       , Gs^Ft       , Gs^Ft       , Rp          , Gs^Fp       , Gs^Fp       , Hh          , Hh          , Hh          , Mm          , Mm^Xm       , Mm^Xm       
Wo          , Wo          , Ww          , Wwf         , Gg^Ve       , Gs^Fp       , Gs^Ft       , Gs^Fp       , Gs^Fp       , Gs^Fp       , Gs^Fp       , Gs^Fp       , Rp          , Gs^Ft       , Gg^Fet      , Gs^Ft       , Ww          , Wo          , Wo          , Ww          , Gs^Fp       , Rp          , Gs^Fp       , Gg          , Gs^Fp       , Gs^Ft       , Gs^Ft       , Gs^Ft       , Gs^Fp       , Gs^Fp       , Gs          , Gg^Ve       , Ggf         , Hh          , Mm          , Mm          , Mm          
Ww          , Ww          , Gs^Ft       , Gs^Ft       , Gs          , Gs^Fp       , Gs^Ft       , Gs^Fp       , Gs^Fp       , Gs^Ft       , Ggf         , Gg          , Rp          , Gs^Fp       , Gs^Ft       , Gs^Ft       , Gs^Ft       , Ww          , Ww          , Ww          , Gs^Fp       , Gs^Fp       , Gs^Fp       , Gs^Fp       , Gs^Fp       , Gs^Fp       , Gs^Fp       , Gs^Fp       , Gs^Fp       , Gs^Fp       , Gg          , Ggf         , Hh          , Hh          , Mm^Xm       , Mm          , Mm          
Hh          , Hh          , Hh          , Gs^Ft       , Gs^Fp       , Gs          , Gs          , Gs^Ft       , Gs          , Gs^Ft       , Gs          , Gg          , Rp          , Gs          , Gg          , Gs^Ft       , Gg^Ve       , Gs^Fp       , Wwf         , Wwf         , Gs^Fp       , Gg          , Gs^Fp       , Gs^Fp       , Gs^Ft       , Gs^Ft       , Gs^Fp       , Gg^Fet      , Gs^Fp       , Rp          , Hh          , Hh          , Hh          , Mm          , Mm          , Mm          , Mm^Xm       
Hh          , Hh          , Gg^Ve       , Gs^Ft       , Gs^Fp       , Gs^Fp       , Gg          , Gs          , Gs^Fp       , Gs^Ft       , Gs^Ft       , Gs^Fp       , Rp          , Gg          , Gs^Fp       , Gs^Ft       , Ww          , Gs^Ft       , Wwf         , Wwf         , Gs^Fp       , Gs^Ft       , Gs^Fp       , Gs^Fp       , Gs^Fp       , Gs^Ft       , Gg          , Gg^Ve       , Rp          , Rp          , Gg          , Hh          , Mm          , Mm^Xm       , Mm          , Mm^Xm       , Mm^Xm       
Hh          , Gg          , Ggf         , Gs          , Gs^Fp       , Ggf         , Ggf         , Gs          , Rp          , Rp          , Rp          , Rp          , Rp          , Gs^Fp       , Gg          , Wwf         , Ww          , Wwf         , Wwf         , Ww          , Ggf         , Gs^Ft       , Gs^Ft       , Gs^Fp       , Gs^Fp       , Gs^Ft       , Gs^Ft       , Gg          , Rp          , Gg          , Ggf         , Hh          , Hh          , Mm          , Mm          , Mm          , Mm          
Hh          , Hh          , Gs^Ft       , Gs^Ft       , Gs^Fp       , Gg^Fet      , Rp          , Rp          , Gs^Ft       , Gg^Ve       , Gs^Ft       , Gs^Ft       , Ggf         , Rp          , Rp          , Gg          , Ggf         , Gg          , Ggf         , Gg          , Gg          , Gs^Ft       , Gs^Fp       , Gs^Fp       , Gs^Fp       , Gs^Fp       , Gs^Ft       , Gg          , Gs^Fp       , Gs^Fp       , Gs^Fp       , Gs^Fp       , Hh          , Hh          , Mm          , Mm          , Mm^Xm       
Hh          , Gs^Fp       , Gs^Fp       , Gs^Fp       , Rp          , Rp          , Gs^Fi       , Gs^Fp       , Gs^Fp       , Gs^Ft       , Gs^Ft       , Ggf         , Gg          , Ggf         , Gg          , Ggf         , Ggf         , Gg          , Ggf         , Ggf         , Ggf         , Gg          , Hh          , Gs^Fp       , Gs^Fp       , Gg^Fet      , Rp          , Rp          , Gg          , Gs^Ft       , Gs^Ft       , Gg^Ve       , Hh          , Hh          , Mm          , Mm^Xm       , Mm^Xm       
Hh          , Hh          , Gs^Fi       , Ce          , Ce          , Gs          , Gs          , Gs          , Gs          , Gs^Ft       , Gs^Ft       , Gg^Ve       , Gg          , Ggf         , Gg          , Ggf         , Gg          , Ggf         , Gg          , Ggf         , Ggf         , Gg          , Ggf         , Gs^Fp       , Gg^Ve       , Gg          , Rp          , Gg          , Gs^Fp       , Gs^Ft       , Gs^Fp       , Hh          , Mm          , Mm          , Mm^Xm       , Mm^Xm       , Mm^Xm       
Hh          , Hh          , Gs          , Ce          , 3 Ke        , Ce          , Gs^Fp       , Gs          , Gs          , Gs^Fp       , Gs^Ft       , Gs^Fp       , Gs^Fp       , Ggf         , Gg          , Gg          , Hh          , Gg          , Ggf         , Gg          , Gg          , Gg          , Rp          , Gg          , Gg          , Gg          , Gg          , Gs^Fp       , Gs^Ft       , Gg^Fet      , Gs^Ft       , Mm          , Mm          , Mm          , Mm          , Mm          , Mm^Xm       
Mm          , Hh          , Gs^Fp       , Gs          , Gs^Fi       , Ce          , Ce          , Gs^Fi       , Gs^Fp       , Gs^Fp       , Gg          , Ggf         , Gs^Fp       , Gg          , Hh          , Ggf         , Ggf         , Hh          , Gg          , Gg          , Gs^Fp       , Ggf         , Gs^Fp       , Rp          , Gs          , Gs^Fp       , Ggf         , Gs^Fp       , Gs^Ft       , Gs^Fp       , Gs^Ft       , Mm          , Mm^Xm       , Mm          , Mm          , Mm          , Mm          
Mm^Xm       , Hh          , Hh          , Gs^Fp       , Gs          , Ce          , Rp          , Gs^Fp       , Gg          , Gg          , Hh          , Gs^Fp       , Gs^Fp       , Hh          , Mm          , Mm^Xm       , Mm          , Hh          , Hh          , Hh          , Gs          , Gs^Fp       , Gs          , Gs          , Gs          , Gs^Fi       , Ce          , Gg          , Gg^Fi       , Gs^Fp       , Hh          , Mm          , Mm          , Mm          , Mm          , Mm          , Mm          
Mm^Xm       , Mm          , Mm          , Hh          , Gs^Fp       , Gs^Fp       , Rp          , Gs^Fp       , Gg^Ve       , Hh          , Hh          , Gs^Fp       , Ce          , Gs^Fp       , Hh          , Mm          , Hh          , Hh          , Gg^Ve       , Hh          , Gs^Fp       , Gs          , Gs          , Gs          , Ce          , Ce          , 4 Ke        , Ce          , Hh          , Ggf         , Mm          , Mm          , Mm          , Mm          , Mm^Xm       , Mm          , Mm^Xm       
Mm^Xm       , Mm          , Mm^Xm       , Hh          , Hh          , Gs^Fp       , Rp          , Rp          , Rp          , Hh          , Gs^Fi       , Ce          , 5 Ke        , Ce          , Gs^Fp       , Hh          , Gs^Fp       , Hh          , Ggf         , Gs^Fp       , Gs^Fp       , Gs          , Gs          , Gs          , Gs^Fi       , Ce          , Ce          , Ce          , Hh          , Hh          , Mm          , Mm          , Mm          , Mm^Xm       , Mm^Xm       , Mm^Xm       , Mm^Xm       
Mm          , Mm^Xm       , Mm^Xm       , Mm^Xm       , Mm          , Hh          , Gs^Fp       , Rp          , Rp          , Gs          , Gs          , Ce          , Ce          , Ce          , Gs^Fi       , Gs^Fp       , Gs^Ft       , Hh          , Gs^Fp       , Gg          , Gg          , Ggf         , Gs          , Gs^Fp       , Gs^Fp       , Gs          , Hh          , Hh          , Mm          , Mm          , Mm          , Mm          , Mm          , Mm^Xm       , Mm          , Mm          , Mm          
Mm          , Mm          , Mm          , Mm          , Hh          , Hh          , Mm          , Hh          , Gs^Fp       , Rp          , Rp          , Gs          , Gs          , Gs^Fp       , Gs^Fp       , Gs^Fp       , Gs^Ft       , Ggf         , Gs^Fp       , Gg          , Gg          , Gg          , Gs          , Gs^Fp       , Gg^Ve       , Hh          , Gs^Ft       , Mm          , Hh          , Mm          , Mm          , Mm          , Mm          , Mm^Xm       , Mm^Xm       , Mm          , Mm^Xm       
Mm^Xm       , Mm^Xm       , Mm          , Mm          , Mm          , Mm          , Gs^Fp       , Gs^Fp       , Hh          , Gs          , Rp          , Gs^Fi       , Gs          , Gs^Fp       , Gs^Fp       , Gs^Fp       , Gs          , Gs^Ft       , Gg          , Ggf         , Gs^Ft       , Gs^Fp       , Gs^Fp       , Gg^Fet      , Hh          , Gs^Ft       , Gs^Ft       , Gs^Fp       , Gs^Fp       , Gs^Ft       , Gs^Ft       , Hh          , Mm          , Mm          , Mm^Xm       , Mm^Xm       , Mm^Xm       
Ww          , Mm^Xm       , Mm          , Mm          , Mm          , Mm          , Hh          , Gg^Fet      , Gs^Fp       , Hh          , Rp          , Gs          , Gs^Ft       , Gs^Ft       , Gs          , Gs^Fp       , Gs^Fp       , Gs^Fp       , Gs          , Gg          , Hh          , Gs^Ft       , Hh          , Gs^Ft       , Hh          , Gs^Ft       , Gs^Fp       , Gs^Fp       , Gs^Ft       , Gs^Fp       , Gs^Ft       , Hh          , Mm          , Mm          , Mm          , Mm^Xm       , Mm^Xm       
Wo          , Ww          , Mm          , Hh          , Hh          , Hh          , Gs^Ft       , Gs^Fp       , Rp          , Rp          , Gs          , Gs          , Hh          , Gs^Ft       , Gs          , Gs^Fp       , Gs^Ft       , Gs^Ft       , Gs^Ft       , Hh          , Mm          , Hh          , Hh          , Hh          , Hh          , Gs^Ft       , Gs^Ft       , Ggf         , Gs          , Rp          , Gs^Fp       , Hh          , Mm          , Mm          , Mm          , Mm^Xm       , Mm^Xm       
Wo          , Wo          , Ww          , Mm          , Mm          , Gs^Ft       , Ggf         , Rp          , Gs^Fp       , Gs^Fp       , Hh          , Hh          , Hh          , Hh          , Mm          , Hh          , Hh          , Gs^Ft       , Mm^Xm       , Hh          , Mm          , Mm          , Gs^Fp       , Hh          , Mm^Xm       , Mm          , Mm          , Gs^Fp       , Gs^Fp       , Rp          , Gs          , Hh          , Hh          , Mm          , Mm          , Mm          , Mm^Xm       
Mm^Xm       , Wo          , Wo          , Mm^Xm       , Mm          , Gs^Fp       , Rp          , Rp          , Mm          , Hh          , Mm^Xm       , Mm          , Hh          , Hh          , Hh          , Mm          , Mm^Xm       , Mm^Xm       , Mm          , Mm          , Hh          , Mm          , Gs^Fp       , Gs^Fp       , Mm          , Hh          , Hh          , Gs^Ft       , Gs^Fp       , Gs^Fp       , Gs^Ft       , Gg^Ve       , Hh          , Hh          , Hh          , Mm          , Mm          
Mm^Xm       , Ww          , Wo          , Mm          , Gs^Fp       , Hh          , Rp          , Hh          , Gs^Fp       , Mm          , Mm          , Hh          , Mm          , Mm          , Mm          , Mm^Xm       , Md^Xm       , Mm^Xm       , Mm          , Mm          , Gs^Fp       , Gs^Fp       , Gs^Fp       , Gs^Fp       , Gs^Fp       , Hh          , Mm^Xm       , Mm          , Cv          , Rp          , Rp          , Gs^Fp       , Gs^Fp       , Gs^Fp       , Hh          , Mm          , Md^Xm       
Mm^Xm       , Ww          , Ww          , Ww          , Wwf         , Rp          , Gs^Fp       , Hh          , Gs^Fp       , Mm          , Mm          , Md^Xm       , Md^Xm       , Hh          , Mm^Xm       , Md^Xm       , Md^Xm       , Mm^Xm       , Mm^Xm       , Mm          , Gs^Fp       , Gs^Fp       , Hh          , Gs^Fp       , Hh          , Gs^Fp       , Mm^Xm       , Gs^Fp       , Cv          , Gs          , Gs^Fp       , Gs^Fp       , Gs^Fp       , Gs^Fp       , Hh          , Mm          , Md^Xm       
Mm^Xm       , Mm          , Mm          , Ww          , Wwf         , Wwf         , Ww          , Gs          , Hh          , Hh          , Md^Xm       , Md          , Md          , Md^Xm       , Md^Xm       , Md^Xm       , Md          , Md^Xm       , Mm^Xm       , Mm          , Gs^Fp       , Gg^Fet      , Gs          , Gs^Fp       , Mm          , Mm^Xm       , Mm          , Gs^Fp       , Gs          , Gs^Fp       , Rp          , Rp          , Cv          , Hh          , Md^Xm       , Md^Xm       , Md          
Mm          , Mm          , Gs^Fp       , Gs^Fp       , Rp          , Wwf         , Ww          , Ww          , Wo          , Mm          , Md^Xm       , Md          , Md          , Md          , Md          , Md          , Md^Xm       , Md^Xm       , Mm          , Mm          , Hh          , Gs^Fp       , Gs          , Hh          , Mm          , Mm          , Gs^Fp       , Gs^Fp       , Gs          , Gs^Fp       , Cv          , Cv          , Cv          , Mm^Xm       , Md^Xm       , Md          , Md^Xm       
Hh          , Hh          , Gs^Fp       , Gs^Fp       , Rp          , Gs          , Gs          , Wo          , Wo          , Mm          , Md^Xm       , Md          , Md^Xm       , Md^Xm       , Md^Xm       , Md          , Md^Xm       , Mm^Xm       , Mm^Xm       , Mm          , Mm          , Hh          , Hh          , Hh          , Hh          , Gs^Fp       , Gs^Fp       , Gs^Fp       , Mm          , Gs^Fp       , Mm          , Mm          , Md^Xm       , Md^Xm       , Md          , Md          , Md^Xm       
