border_size=1
usage=map

Xu          , Xu          , Xu          , Xu          , Xu          , Xu          , Xu          , Xu          , Xu          , Xu          , Xu          , Xu          , Xu          , Xu          , Xu          , Xu          , Xu          , Xu          , Xu          , Xu          , Xu          , Xu          , Xu          , Xu          , Xu          , Xu          , Xu          , Xu          , Xu          , Xu          , Xu          , Xu          , Xu          , Xu          , Xu          , Ryd         , Ryd         , Ryd         , Ryd         , Xu          , Xu          , Xu          
Xu          , Xu          , Xu          , Xu          , Uu          , Xu          , Uu^Ii       , Xu          , Uu          , Xu          , Uu          , Xu          , Uu          , Xu          , Uu          , Xu          , Uu          , Xu          , Uu          , Xu          , Uu          , Xu          , Uh          , Xu          , Xu          , Xu          , Xu          , Xu          , Xu          , Xu          , Xu          , Xu          , Xu          , Xu          , Ryd         , Ryd         , Ryd         , Ryd         , Xu          , Xu          , Xu          , Xu          
Xu          , Xu          , Xu          , Xu          , Uu          , Ryd         , Ryd         , Ryd         , Ryd         , Ryd         , Ryd         , Ryd         , Ryd         , Ryd         , Ryd         , Ryd         , Ryd         , Ryd         , Ryd         , Ryd         , Ryd         , Ryd         , Ryd         , Uu          , Uu          , Xu          , Xu          , Xu          , Uh          , Xu          , Uh          , Xu          , Xu          , Xu          , Ryd         , Ryd         , Ryd         , Xu          , Xu          , Xu          , Xu          , Xu          
Xu          , Xu          , Xu          , Xu          , Uu          , Ryd         , Uu          , Uu          , Xu          , Uu          , Xu          , Uu          , Xu          , Uu^Ii       , Xu          , Uu          , Xu          , Uu          , Xu          , Uu          , Xu          , Uu          , Uu          , Ryd         , Ryd         , Uh          , Uu          , Uu^Uf       , Uh          , Uu^Ii       , Uu^Ii       , Uu^Ii       , Uh          , Ryd         , Ryd         , 1 Ryd       , Ryd         , Xu          , Xu          , Xu          , Xu          , Xu          
Xu          , Xu          , Xu          , Xu          , Uu          , Ryd         , Uu          , Xu          , Xu          , Xu          , Xu          , Xu          , Xu          , Xu          , Xu          , Xu          , Xu          , Xu          , Xu          , Xu          , Xu          , Xu          , Xu          , Uh          , Uh          , Ryd         , Ryd         , Uu          , Uu          , Uh          , Uh          , Uu          , Ryd         , Ryd         , Ryd         , Ryd         , Xu          , Xu          , Xu          , Xu          , Xu          , Xu          
Xu          , Xu          , Xu          , Xu          , Uu^Ii       , Ryd         , Uu          , Xu          , Xu          , Xu          , Xu          , Xu          , Qxu         , Qxu         , Qxu         , Qxu         , Qxu         , Xu          , Xu          , Xu          , Xu          , Xu          , Xu          , Uh          , Uh          , Uu          , Uu          , Ryd         , Ryd         , Uh          , Ryd         , Ryd         , Ryd         , Ryd         , Uu          , Uu          , Xu          , Xu          , Xu          , Xu          , Xu          , Xu          
Xu          , Xu          , Xu          , Xu          , Uu          , Ryd         , Uu          , Xu          , Xu          , Xu          , Xu          , Xu          , Qxu         , Qxu         , Uu^Ii       , Qxu         , Qxu         , Xu          , Xu          , Xu          , Xu          , Xu          , Xu          , Xu          , Xu          , Xu          , Xu          , Uu          , Ryd         , Ryd         , Ryd         , Ryd         , Uh          , Uu^Ii       , Ryd         , Uh^Ii       , Xu          , Xu          , Xu          , Xu          , Xu          , Xu          
Xu          , Xu          , Xu          , Qxu         , Uu          , Ryd         , Uu          , Xu          , Xu          , Xu          , Xu          , Xu          , Qxu         , Qxu         , Uu          , Qxu         , Qxu         , Xu          , Xu          , Xu          , Xu          , Xu          , Xu          , Xu          , Xu          , Xu          , Uu^Uf       , Xu          , Ryd         , Ryd         , Uu^Uf       , Uu^Uf       , Uh          , Uu^Ii       , Uh^Ii       , Ryd         , Xu          , Xu          , Xu          , Xu          , Xu          , Xu          
Xu          , Xu          , Qxu         , Qxu         , Uu          , Ryd         , Uu          , Qxu         , Xu          , Xu          , Xu          , Xu          , Xu          , Qxu         , Uu          , Qxu         , Xu          , Xu          , Xu          , Xu          , Xu          , Xu          , Qxu         , Xu          , Uh          , Xu          , Uu^Uf       , Ryd         , Ryd         , Ryd         , Uu^Uf       , Uu^Uf       , Xu          , Ryd         , Uh          , Uh^Ii       , Xu          , Ryd         , Uu          , Xu          , Xu          , Xu          
Xu          , Qxu         , Qxu         , Qxu         , Qxu         , Ryd         , Qxu         , Qxu         , Qxu         , Qxu         , Xu          , Xu          , Xu          , Qxu         , Xu          , Qxu         , Xu          , Xu          , Xu          , Xu          , Xu          , Xu          , Qxu         , Xu          , Uu^Uf       , Uh          , Ryd         , Ryd         , Qxu         , Qxu         , Xu          , Xu          , Xu          , Xu          , Xu          , Xu          , Xu          , Ryd         , Uu          , Xu          , Xu          , Xu          
Xu          , Qxu         , Qxu         , Qxu         , Qxu         , Ryd         , Qxu         , Qxu         , Qxu         , Qxu         , Xu          , Xu          , Xu          , Xu          , Ryd         , Xu          , Xu          , Xu          , Xu          , Xu          , Xu          , Qxu         , Uh          , Uu^Uf       , Uu^Uf       , Ryd         , Uu^Uf       , Uh          , Qxu         , Xu          , Xu          , Xu          , Xu          , Xu          , Qxu         , Xu          , Xu          , Ryd         , Uu          , Xu          , Xu          , Xu          
Xu          , Qxu         , Qxu         , Qxu         , Qxu         , Ryd         , Qxu         , Qxu         , Qxu         , Qxu         , Xu          , Xu          , Ryd         , Ryd         , Ryd         , Ryd         , Ryd         , Uu^Ii       , Xu          , Xu          , Xu          , Qxu         , Uu^Uf       , Uh          , Ryd         , Ryd         , Uh          , Uu^Uf       , Xu          , Xu          , Xu          , Xu          , Xu          , Xu          , Qxu         , Qxu         , Xu          , Ryd         , Uu          , Xu          , Xu          , Xu          
Xu          , Qxu         , Xu          , Qxu         , Rd          , Ryd         , Uu          , Qxu         , Xu          , Qxu         , Xu          , Ryd         , Ryd         , Ryd         , Xu          , Ryd         , Ryd         , Ryd         , Ryd         , Xu          , Xu          , Uh          , Ryd         , Ryd         , Uu^Uf       , Uu^Uf       , Qxu         , Uh          , Xu          , Xu          , Xu          , Xu          , Xu          , Qxu         , Qxu         , Uu          , Uu          , Ryd         , Ryd         , Xu          , Xu          , Xu          
Xu          , Xu          , Xu          , Xu          , Rd          , Ryd         , Rd          , Xu          , Xu          , Xu          , Xu          , Ryd         , Ryd         , Xu          , Qxu         , Xu          , Xu          , Ryd         , Ryd         , Ryd         , Ryd         , Xu          , Xu          , Uh          , Uu^Uf       , Uh          , Qxu         , Xu          , Xu          , Xu          , Xu          , Xu          , Xu          , Xu          , Qxu         , Qxu         , Uu          , Uu          , Ryd         , Qxu         , Xu          , Xu          
Xu          , Xu          , Xu          , Xu          , Uu^Ii       , Ryd         , Uu^Ii       , Uh          , Xu          , Xu          , Xu          , Ryd         , Ryd         , Xu          , Qxu         , Qxu         , Uu          , Xu          , Xu          , Ryd         , Ryd         , Ryd         , Ryd         , Xu          , Xu          , Uh          , Xu          , Qxu         , Xu          , Xu          , Xu          , Xu          , Xu          , Qxu         , Uu          , Qxu         , Uu          , Uu          , Ryd         , Qxu         , Xu          , Xu          
Xu          , Xu          , Uu^Ii       , Uh          , Uu^Ii       , Zw          , Uh^Ii       , Uu^Ii       , Uh^Ii       , Xu          , Xu          , Ryd         , Ryd         , Xu          , Uu          , Uu          , Uu          , Uu          , Qxu         , Xu          , Xu          , Ryd         , Ryd         , Ryd         , Ryd         , Xu          , Xu          , Xu          , Xu          , Xu          , Xu          , Xu          , Xu          , Qxu         , Qxu         , Uu          , Ryd         , Ryd         , Qxu         , Qxu         , Qxu         , Xu          
Xu          , Xu          , Uh          , Uu^Ii       , Uh          , Ryd         , Uh^Ii       , Uh          , Uh^Ii       , Uh          , Xu          , Ryd         , Ryd         , Xu          , Xu          , Uu          , Xu          , Qxu         , Xu          , Qxu         , Xu          , Xu          , Xu          , Ryd         , Ryd         , Ryd         , Xu          , Xu          , Xu          , Xu          , Xu          , Xu          , Xu          , Xu          , Qxu         , Ryd         , Uu          , Qxu         , Uu          , Uu          , Qxu         , Qxu         
Xu          , Xu          , Uh          , Uh^Ii       , Uh          , Ryd         , Zw          , Uh          , Uh          , Uh          , Xu          , Ryd         , Ryd         , Xu          , Ryd         , Xu          , Ryd         , Xu          , Ryd         , Xu          , Ryd         , Xu          , Ryd         , Xu          , Ryd         , Ryd         , Xu          , Xu          , Xu          , Xu          , Xu          , Xu          , Xu          , Xu          , Xu          , Ryd         , Xu          , Uu          , Uu          , Qxu         , Qxu         , Qxu         
Xu          , Xu          , Uh          , Uh^Ii       , Uh          , Uu^Uf       , Ryd         , Uu^Ii       , Uh          , Xu          , Xu          , Ryd         , Ryd         , Ryd         , Ryd         , Ryd         , Ryd         , Ryd         , Ryd         , Ryd         , Ryd         , Ryd         , Ryd         , Ryd         , Ryd         , Ryd         , Xu          , Xu          , Xu          , Xu          , Xu          , Xu          , Xu          , Ryd         , Xu          , Xu          , Xu          , Qxu         , Qxu         , Qxu         , Qxu         , Qxu         
Xu          , Xu          , Xu          , Uh          , Xu          , Xu          , Ryd         , Uu^Uf       , Xu          , Xu          , Ryd         , Ryd         , Xu          , Xu          , Xu          , Xu          , Uu^Ii       , Xu          , Xu          , Xu          , Xu          , Xu          , Xu          , Xu          , Xu          , Xu          , Xu          , Xu          , Xu          , Xu          , Xu          , Ryd         , Xu          , Xu          , Xu          , Xu          , Xu          , Xu          , Qxu         , Qxu         , Qxu         , Qxu         
Xu          , Xu          , Xu          , Xu          , Xu          , Xu          , Ryd         , Xu          , Xu          , Xu          , Xu          , Xu          , Xu          , Xu          , Xu          , Xu          , Xu          , Xu          , Qxu         , Ryd         , Ryd         , Ryd         , Ryd         , Ryd         , Xu          , Xu          , Xu          , Xu          , Qxu         , Xu          , Xu          , Xu          , Xu          , Xu          , Qxu         , Xu          , Xu          , Xu          , Xu          , Qxu         , Qxu         , Qxu         
Xu          , Xu          , Xu          , Xu          , Xu          , Xu          , Rd          , Uu^Uf       , Uu^Uf       , Xu          , Xu          , Xu          , Xu          , Xu          , Xu          , Xu          , Xu          , Xu          , Qxu         , Ryd         , Ryd         , Qxu         , Ryd         , Ryd         , Xu          , Xu          , Xu          , Xu          , Qxu         , Qxu         , Xu          , Ryd         , Xu          , Qxu         , Qxu         , Xu          , Xu          , Xu          , Xu          , Qxu         , Qxu         , Qxu         
Xu          , Xu          , Xu          , Uu^Ii       , Uu          , Uu          , Rd          , Rd          , Xu          , Xu          , Xu          , Xu          , Xu          , Xu          , Xu          , Xu          , Xu          , Qxu         , Qxu         , Ryd         , Ryd         , Qxu         , Ryd         , Ryd         , Ryd         , Xu          , Xu          , Xu          , Qxu         , Qxu         , Uu          , Xu          , Uu          , Qxu         , Qxu         , Xu          , Xu          , Xu          , Uu          , Xu          , Qxu         , Qxu         
Xu          , Xu          , Xu          , Xu          , Xu          , Uu          , Xu          , Xu          , Xu          , Xu          , Xu          , Xu          , Xu          , Xu          , Xu          , Xu          , Xu          , Qxu         , Qxu         , Ryd         , Ryd         , Qxu         , Qxu         , Ryd         , Ryd         , Xu          , Xu          , Xu          , Qxu         , Qxu         , Uu          , Ryd         , Uu          , Qxu         , Qxu         , Xu          , Uu          , Uu          , Uu          , Xu          , Xu          , Qxu         
Xu          , Xu          , Xu          , Xu          , Xu          , Uu          , Xu          , Xu          , Xu          , Xu          , Uh^Ii       , Xu          , Qxu         , Xu          , Xu          , Xu          , Xu          , Qxu         , Qxu         , Ryd         , Ryd         , Ryd         , Ryd         , Ryd         , Ryd         , Qxu         , Xu          , Xu          , Qxu         , Qxu         , Uu          , Uu^Ii       , Uu          , Qxu         , Qxu         , Xu          , Xu          , Uu          , Xu          , Xu          , Xu          , Xu          
Xu          , Xu          , Xu          , Xu          , Xu          , Xu          , Qxu         , Rd          , Rd          , Uu^Ii       , Uu^Ii       , Uh^Ii       , Qxu         , Qxu         , Xu          , Xu          , Xu          , Xu          , Qxu         , Qxu         , Qxu         , Ryd         , Ryd         , Ryd         , Uu          , Qxu         , Qxu         , Xu          , Xu          , Qxu         , Qxu         , Uu          , Qxu         , Qxu         , Qxu         , Xu          , Xu          , Xu          , Xu          , Xu          , Xu          , Xu          
Xu          , Xu          , Qxu         , Xu          , Qxu         , Qxu         , Qxu         , Uu^Ii       , Uu^Ii       , Ryd         , Uu^Ii       , Uu^Ii       , Qxu         , Qxu         , Qxu         , Xu          , Xu          , Xu          , Xu          , Qxu         , Qxu         , Ryd         , Uu          , Uu          , Qxu         , Uu          , Qxu         , Xu          , Xu          , Qxu         , Qxu         , Qxu         , Qxu         , Qxu         , Xu          , Xu          , Xu          , Ryd         , Xu          , Xu          , Xu          , Xu          
Xu          , Xu          , Xu          , Qxu         , Qxu         , Qxu         , Qxu         , Uh^Ii       , Uh^Ii       , Uu^Ii       , Qxu         , Qxu         , Qxu         , Qxu         , Xu          , Xu          , Xu          , Qxu         , Xu          , Qxu         , Qxu         , Uu          , Qxu         , Uu          , Uu          , Uu          , Uu          , Qxu         , Xu          , Xu          , Xu          , Xu          , Xu          , Xu          , Xu          , Xu          , Xu          , Ryd         , Xu          , Xu          , Xu          , Xu          
Xu          , Xu          , Xu          , Xu          , Qxu         , Qxu         , Xu          , Qxu         , Qxu         , Qxu         , Qxu         , Qxu         , Xu          , Xu          , Xu          , Xu          , Xu          , Qxu         , Uu^Uf       , Xu          , Qxu         , Uu          , Re          , Re          , Xu          , Xu          , Xu          , Re          , Xu          , Xu          , Xu          , Xu          , Qxu         , Xu          , Xu          , Xu          , Xu          , Ryd         , Ryd         , Xu          , Xu          , Xu          
Xu          , Xu          , Xu          , Xu          , Xu          , Xu          , Xu          , Xu          , Qxu         , Qxu         , Xu          , Xu          , Xu          , Xu          , Qxu         , Xu          , Ryd         , Re^Uf       , Uu^Uf       , Uu^Ii       , Qxu         , Re          , Xu          , Xu          , Re          , Uu^Uf       , Rd          , Re          , Ryd         , Uh          , Uh^Ii       , Qxu         , Xu          , Xu          , Xu          , Xu          , Xu          , Xu          , Xu          , Ryd         , Xu          , Xu          
Xu          , Xu          , Xu          , Xu          , Xu          , Xu          , Xu          , Xu          , Xu          , Xu          , Xu          , Xu          , Xu          , Qxu         , Uh^Ii       , Re          , Ryd         , Ryd         , Re^Uf       , Uu          , Ryd         , Re          , Ryd         , Ryd         , Rd          , Re          , Uu          , Xu          , Ryd         , Uh          , Uh^Ii       , Qxu         , Xu          , Xu          , Xu          , Xu          , Xu          , Xu          , Xu          , Ryd         , Ryd         , Xu          
Xu          , Xu          , Xu          , Xu          , Xu          , Xu          , Xu          , Xu          , Xu          , Xu          , Xu          , Xu          , Uu^Ii       , Uu^Ii       , Uh^Ii       , Uh          , Uh          , Re          , Uu          , Rd          , Rd          , Xu          , Uu          , Ryd         , Re          , Uu          , Uu^Ii       , Uh          , Rd          , Rd          , Uu^Ii       , Qxu         , Xu          , Xu          , Xu          , Xu          , Xu          , Xu          , Xu          , Xu          , Xu          , Ryd         
Xu          , Xu          , Xu          , Xu          , Xu          , Xu          , Xu          , Xu          , Xu          , Xu          , Xu          , Qxu         , Uh          , Uu^Ii       , Uh          , Uh          , Uh^Ii       , Uu^Ii       , Uu^Ii       , Uu^Uf       , Re^Uf       , Uu^Ii       , Re          , Rd          , Rd          , Uu^Uf       , Uu^Ii       , Uu^Ii       , Uh          , Rd          , Uh          , Xu          , Xu          , Xu          , Xu          , Xu          , Xu          , Xu          , Xu          , Xu          , Xu          , Xu          
Xu          , Xu          , Xu          , Xu          , Xu          , Xu          , Xu          , Xu          , Xu          , Xu          , Xu          , Qxu         , Uh          , Uu^Uf       , Uu^Uf       , Uu^Uf       , Uh          , Uu^Ii       , Uu^Ii       , Re^Uf       , Re^Uf       , Ryd         , Uh^Ii       , Uu^Ii       , Rd          , Re          , Uu^Ii       , Uh^Ii       , Uh^Ii       , Rd          , Uh          , Xu          , Qxu         , Qxu         , Xu          , Xu          , Xu          , Xu          , Xu          , Xu          , Xu          , Xu          
Xu          , Xu          , Xu          , Xu          , Xu          , Xu          , Xu          , Xu          , Xu          , Xu          , Xu          , Xu          , Uh          , Uu^Uf       , Uh          , Uh          , Uu          , Uh^Ii       , Uh          , Uu^Uf       , Uu          , Uu^Ii       , Uh^Ii       , Uh^Ii       , Rd          , Ryd         , Uu^Ii       , Uh^Ii       , Uh^Ii       , Uh          , Uu^Ii       , Xu          , Qxu         , Xu          , Xu          , Xu          , Xu          , Xu          , Xu          , Xu          , Xu          , Xu          
Xu          , Xu          , Xu          , Xu          , Xu          , Xu          , Xu          , Xu          , Xu          , Xu          , Xu          , Xu          , Re          , Uh          , Uh          , Uh          , Uu^Ii       , Uu^Ii       , Uh          , Uh          , Uh          , Rd          , Rd          , Uh^Ii       , Ryd         , Ryd         , Uu^Ii       , Uh^Ii       , Uu^Ii       , Uh^Ii       , Uh          , Qxu         , Xu          , Xu          , Xu          , Xu          , Xu          , Xu          , Xu          , Xu          , Xu          , Xu          
Xu          , Xu          , Xu          , Xu          , Xu          , Xu          , Uu^Uf       , Rd          , Rd          , Ryd         , Ryd         , Xu          , Uu          , Rd          , Uh          , Uh          , Uh^Ii       , Uu^Ii       , Uu^Ii       , Uh^Ii       , Re^Uf       , Uu          , Rd          , Uu          , Uu          , Rd          , Rd          , Uu          , Uu^Uf       , Uu^Uf       , Uh          , Qxu         , Qxu         , Xu          , Xu          , Xu          , Xu          , Xu          , Xu          , Xu          , Xu          , Xu          
Xu          , Xu          , Xu          , Xu          , Xu          , Xu          , Ryd         , Ryd         , Xu          , Uu^Uf       , Rd          , Xu          , Uh          , Rd          , Uh^Ii       , Uh          , Uh^Ii       , Uh          , Uu^Ii       , Uh^Ii       , Re^Uf       , Re^Uf       , Uu          , Uu          , Uh^Ii       , Uh^Ii       , Rd          , Rd          , Uh^Ii       , Re^Uf       , Uu^Uf       , Qxu         , Qxu         , Uh          , Xu          , Xu          , Xu          , Xu          , Xu          , Xu          , Xu          , Xu          
Xu          , Xu          , Uu^Uf       , Uh          , Rd          , Rd          , Ryd         , Xu          , Xu          , Xu          , Xu          , Xu          , Qxu         , Uh          , Rd          , Uh^Ii       , Uh^Ii       , Uh          , Uh          , Uh          , Re          , Uu          , Uu^Ii       , Uh^Ii       , Uu^Ii       , Uu^Ii       , Uu^Ii       , Rd          , Uh^Ii       , Uu^Ii       , Uu^Uf       , Uh          , Qxu         , Uu^Ii       , Xu          , Xu          , Xu          , Xu          , Xu          , Xu          , Xu          , Xu          
Xu          , Xu          , Rd          , Ryd         , Uh          , Uh          , Xu          , Xu          , Xu          , Xu          , Xu          , Xu          , Xu          , Qxu         , Qxu         , Rd          , Uh          , Uh          , Uu          , Uu          , Uu          , Rd          , Rd          , Rd          , Ryd         , Re^Uf       , Uu^Uf       , Uh^Ii       , Uh          , Uh          , Uh          , Uu          , Uh          , Uh          , Xu          , Xu          , Xu          , Xu          , Xu          , Xu          , Xu          , Xu          
Uu          , Uu^Uf       , Ryd         , Xu          , Xu          , Xu          , Xu          , Xu          , Xu          , Xu          , Xu          , Xu          , Xu          , Xu          , Xu          , Xu          , Xu          , Uu          , Xu          , Uu^Ii       , Xu          , Uu          , Xu          , Uu          , Xu          , Uu^Uf       , Xu          , Uu^Uf       , Xu          , Uh          , Xu          , Xu          , Xu          , Xu          , Xu          , Xu          , Xu          , Xu          , Xu          , Xu          , Xu          , Xu          
Ryd         , Ryd         , Xu          , Xu          , Xu          , Xu          , Xu          , Xu          , Xu          , Xu          , Xu          , Xu          , Xu          , Xu          , Xu          , Xu          , Xu          , Xu          , Xu          , Xu          , Xu          , Xu          , Xu          , Xu          , Xu          , Xu          , Xu          , Xu          , Xu          , Xu          , Xu          , Xu          , Xu          , Xu          , Xu          , Xu          , Xu          , Xu          , Xu          , Xu          , Xu          , Xu          
