border_size=1
usage=map

Xu          , Xu          , Xu          , Xu          , Xu          , Uu          , Uu          , Uh          , Uh          , Uh          , Ce          , Ce          , Ce          , Uh^Ii       , Rd          , Re^Uf       , Uh          , Uh          , Uu          , Xu          , Rd          , Rd          , Uu          , Xu          , Xu          , Xu          , Xu          , Xu          , Xu          , Xu          , Xu          , Xu          
Xu          , Xu          , Xu          , Xu          , Xu          , Uu          , Uu          , Uh          , Uh          , Uh          , Ce          , Ce          , Ce          , Uh^Ii       , Rd          , Re^Uf       , Uh          , Uh          , Uu          , Xu          , Rd          , Rd          , Uu          , Xu          , Xu          , Xu          , Xu          , Xu          , Xu          , Xu          , Xu          , Xu          
Xu          , Xu          , Xu          , Xu          , Xu          , Qxu         , Qxu         , Uh          , Uu          , Ce          , Uu^Vu       , 6 Ke        , Uu^Vud      , Ce          , Re^Uf       , Re^Uf       , Uh          , Uu^Uf       , Uu^Uf       , Rd          , Uu          , Uu          , Uh          , Xu          , Uu^Uf       , Xu          , Xu          , Xu          , Xu          , Xu          , Xu          , Xu          
Xu          , Xu          , Xu          , Xu          , Xu          , Xu          , Qxu         , Qxu         , Re^Uf       , Ce          , Ce          , Ce          , Ce          , Ce          , Re^Uf       , Re^Uf       , Uh          , Uu^Uf       , Uu^Vu       , Rd          , Uu^Uf       , Uh          , Uh          , Uu^Uf       , Uu^Uf       , Xu          , Uh^Ii       , Xu          , Xu          , Xu          , Xu          , Xu          
Xu          , Xu          , Xu          , Xu          , Xu          , Xu          , Qxu         , Qxu         , Re^Uf       , Re^Uf       , Rr          , Rr          , Uu^Uf       , Uu          , Uu^Uf       , Uh          , Uu^Uf       , Uu^Uf       , Uu^Ii       , Rd          , Uu          , Uu          , Re^Uf       , Re^Uf       , Re^Uf       , Uh^Ii       , Uh^Ii       , Xu          , Xu          , Xu          , Xu          , Xu          
Qxu         , Qxu         , Qxu         , Qxu         , Qxu         , Qxu         , Uu^Ii       , Uu^Ii       , Rd          , Rd          , Rr          , Rr          , Uu^Uf       , Uu^Uf       , Uu^Uf       , Uh          , Uu^Uf       , Uu^Uf       , Uu^Ii       , Rd          , Rd          , Uu^Ii       , Re^Uf       , Uu^Uf       , Uu^Uf       , Uh          , Xu          , Xu          , Xu          , Xu          , Xu          , Xu          
Uu          , Uu          , Uu          , Uu          , Uu          , Uu          , Uu^Vu       , Uu^Ii       , Rd          , Re^Uf       , Rr          , Rr          , Rr          , Uh          , Uh^Ii       , Uh          , Uh          , Uu^Uf       , Rd          , Re^Uf       , Re^Uf       , Uu^Vud      , Uu          , Uu^Uf       , Uh          , Re^Uf       , Xu          , Xu          , Xu          , Xu          , Xu          , Xu          
Rr          , Rr          , Rr          , Rr          , Rr          , Rr          , Rr          , Uu          , Rr          , Rr          , Re          , Rd          , Rd          , Rr          , Uu^Ii       , Uu^Ii       , Rd          , Rd          , Re^Uf       , Rd          , Uu          , Uu          , Uu          , Uh          , Uh^Ii       , Uh^Ii       , Uu^Uf       , Uu^Vud      , Xu          , Xu          , Xu          , Xu          
Uu          , Uu          , Uh          , Uu^Uf       , Uu^Uf       , Uu^Uf       , Uu          , Rr          , Rr          , Uu          , Uu^Uf       , Uu          , Uu^Vu       , Rd          , Rd          , Uu          , Re^Uf       , Re^Uf       , Re^Uf       , Uu          , Uh          , Uh          , Uu          , Uu^Uf       , Uu^Vu       , Uh^Ii       , Uu^Uf       , Re^Uf       , Uh          , Xu          , Xu          , Xu          
Uh          , Uh          , Re          , Uu^Uf       , Re          , Re^Uf       , Ce          , Ce          , Ce          , Rr          , Rr          , Uu          , Uu          , Rr          , Uu^Uf       , Uu^Uf       , Uu          , Re^Uf       , Re^Uf       , Uu^Vu       , Uh          , Uh          , Uu^Uf       , Re^Uf       , Uu          , Uh          , Uu^Uf       , Uh          , Uu^Uf       , Uh          , Xu          , Xu          
Rd          , Rd          , Uh          , Uu^Uf       , Uu^Vu       , Re          , Ce          , 9 Ke        , Ce          , Uu^Uf       , Uu          , Rr          , Uu          , Rr          , Rr          , Uu^Uf       , Rd          , Re^Uf       , Re^Uf       , Uh          , Uh          , Uu^Uf       , Uu^Uf       , Re^Uf       , Uu^Ii       , Uu^Uf       , Uu          , Uh          , Uh          , Uh          , Uu^Uf       , Uu^Uf       
Uu          , Uu          , Uh          , Uu          , Re^Uf       , Rd          , Re          , Ce          , Uu^Uf       , Uu          , Uu          , Rr          , Rr          , Re^Uf       , Rr          , Uu          , Re          , Re^Uf       , Uh          , Re^Uf       , Re^Uf       , Uu          , Rd          , Uh          , Uu^Vud      , Uu^Uf       , Uu          , Uu^Vud      , Ce          , Uu^Uf       , Uu^Uf       , Uu^Uf       
Xu          , Xu          , Xu          , Uh          , Uh          , Re^Uf       , Re^Uf       , Re          , Uu^Uf       , Rr          , Uu          , Uu          , Uh          , Rr          , Rr          , Rd          , Re          , Uh          , Uu^Vu       , Uu          , Uu^Vud      , Rd          , Rd          , Uh          , Rd          , Uu^Uf       , Uu          , Ce          , 3 Ke        , Uh          , Uh          , Uh          
Xu          , Xu          , Uh          , Uh          , Uu^Vud      , Uu^Uf       , Re^Uf       , Re^Uf       , Re^Uf       , Rr          , Uu^Vud      , Uu          , Uh          , Uh          , Uu^Uf       , Rr          , Rr          , Re^Uf       , Ce          , Ce          , Ce          , Uu          , Rd          , Rd          , Rd          , Uu^Uf       , Uu          , Ce          , Ce          , Ce          , Uu^Uf       , Uu^Uf       
Xu          , Xu          , Uh          , Uh          , Xu          , Uu          , Uh          , Uh          , Rd          , Rd          , Re^Uf       , Rd          , Uu^Uf       , Uh          , Rd          , Rd          , Rr          , Rd          , Ce          , 1 Ke        , Ce          , Uu^Vud      , Uu^Uf       , Rd          , Rd          , Rd          , Uu          , Uu^Vu       , Uu          , Uh          , Uh          , Uh          
Xu          , Xu          , Xu          , Xu          , Xu          , Xu          , Uh          , Uh          , Rr          , Re          , Re          , Re^Uf       , Rr          , Uu^Uf       , Re          , Re^Uf       , Re          , Uu^Vud      , Rd          , Ce          , Uu^Vu       , Uu          , Rd          , Rd          , Uu^Vu       , Rd          , Rd          , Rd          , Uu          , Uh          , Rd          , Rd          
Xu          , Xu          , Xu          , Xu          , Xu          , Xu          , Uh          , Uh          , Rr          , Uu^Uf       , Uh          , Re          , Uu^Uf       , Re^Uf       , Re^Uf       , Rr          , Re^Uf       , Re^Uf       , Rd          , Rd          , Cud         , Uu          , Uu^Uf       , Uu^Uf       , Uu          , Uu^Ii       , Uu^Ii       , Rd          , Rr          , Rd          , Rr          , Rr          
Uu          , Uu          , Rr          , Uu          , Uu          , Xu          , Uu^Ii       , Uh          , Rr          , Uh          , Uh          , Uu^Uf       , Uu          , Uu^Vu       , Uh          , Uh          , Rr          , Re^Uf       , Uu          , Cud         , 8 Kud       , Cud         , Re^Uf       , Uu          , Uh          , Uu^Ii       , Rr          , Rr          , Uu          , Rr          , Uu          , Uu          
Rr          , Rr          , Uu          , Rr          , Rr          , Rr          , Rr          , Rr          , Uh          , Uh          , Uu^Uf       , Uh          , Uu^Uf       , Uu^Uf       , Uu^Uf       , Uu          , Rr          , Uu          , Uu          , Cud         , Cud         , Cud         , Re^Uf       , Re^Uf       , Rr          , Rr          , Uu          , Uu          , Uh          , Uu^Vu       , Uu^Uf       , Uu^Uf       
Rr          , Rr          , Rd          , Uu          , Uu          , Uh          , Uh^Ii       , Rr          , Rr          , Uu^Vu       , Uu^Uf       , Uh          , Uu^Uf       , Uu^Uf       , Rd          , Rd          , Rr          , Rd          , Uu          , Re^Uf       , Uu^Uf       , Uu^Uf       , Re^Uf       , Uh          , Rr          , Uu          , Uu^Uf       , Uu^Vud      , Uh          , Uu^Uf       , Xu          , Xu          
Rd          , Rd          , Uu          , Rd          , Rd          , Uh^Ii       , Uh^Ii       , Uu^Ii       , Rr          , Uu          , Uu^Uf       , Uu^Uf       , Uu^Uf       , Uu^Uf       , Cud         , Cud         , Rr          , Cud         , Cud         , Uu          , Re^Uf       , Uu^Uf       , Re^Uf       , Rr          , Uu^Vud      , Uu          , Uu^Uf       , Uh          , Uu^Uf       , Uu^Uf       , Xu          , Xu          
Uu          , Uu          , Uu^Uf       , Uu          , Uu^Ii       , Rd          , Uu          , Uu          , Uu          , Rr          , Rr          , Uu          , Cud         , Cud         , Uu^Vud      , Rd          , Wo^Bw|      , Uu          , Uu^Vud      , Cud         , Cud         , Re^Uf       , Rr          , Rr          , Uu          , Uu          , Uh          , Uu^Uf       , Xu          , Xu          , Xu          , Xu          
Uh          , Uh          , Uh          , Uu^Uf       , Uu^Ii       , Rd          , Uu^Vu       , Uu^Uf       , Uu^Uf       , Uh          , Uh          , Rr          , Rr          , Uu          , Wo          , Wo          , Cud         , Wo          , Wo          , Uu          , Rr          , Rr          , Uu^Vud      , Uu          , Uh          , Uh          , Xu          , Xu          , Xu          , Xu          , Xu          , Xu          
Uh          , Uh          , Uh          , Uu          , Uu^Uf       , Uu          , Uh          , Uu^Uf       , Uu^Uf       , Uu^Uf       , Cud         , Cud         , Uu          , Wo^Bw\      , Cud         , Cud         , Uu^Cd       , Cud         , Cud         , Wo^Bw/      , Uu          , Cud         , Cud         , Uh          , Uh          , Uh          , Xu          , Xu          , Xu          , Xu          , Xu          , Xu          
Uh          , Uh          , Uh          , Uh          , Uu^Uf       , Uu^Uf       , Uu^Uf       , Uu^Uf       , Uh          , Uu^Vu       , Cud         , Uu^Vud      , Uh          , Wo          , Cud         , Uu^Cd       , 2 Uu^Kd     , Uu^Cd       , Cud         , Wo          , Uu          , Uu^Vud      , Cud         , Uu^Uf       , Xu          , Xu          , Xu          , Xu          , Xu          , Xu          , Xu          , Xu          
Uh          , Uh          , Uh          , Uh          , Uh          , Uu^Uf       , Uh^Ii       , Uh^Ii       , Uu^Uf       , Uu^Uf       , Cud         , Uu^Uf       , Uh          , Wo          , Cud         , Uu^Cd       , Uu^Cd       , Uu^Cd       , Cud         , Wo          , Uu^Uf       , Uu          , Cud         , Uh          , Uu^Uf       , Xu          , Xu          , Xu          , Uu^Vu       , Xu          , Uh          , Uh          
Rd          , Rd          , Rd          , Uu^Uf       , Rd          , Uu          , Uu^Ii       , Uh^Ii       , Uu          , Uh          , Uh          , Cud         , Rr          , Wo^Bw/      , Wo          , Cud         , Cud         , Cud         , Wo          , Wo^Bw\      , Rr          , Cud         , Uu          , Uu^Vud      , Rr          , Xu          , Rr          , Uu^Uf       , Rr          , Rr          , Rr          , Rr          
Xu          , Xu          , Uu          , Rd          , Uu^Uf       , Rd          , Rd          , Uu^Ii       , Rd          , Uu          , Rr          , Rr          , Cud         , Uu^Uf       , Uu^Vud      , Wo          , Wo^Bw|      , Wo          , Uu^Vud      , Uu          , Cud         , Rr          , Rr          , Rr          , Uu^Ii       , Rr          , Rr          , Rr          , Uu^Uf       , Uu^Uf       , Uu^Uf       , Uu^Uf       
Xu          , Xu          , Xu          , Xu          , Uu          , Uu          , Uu^Vud      , Rd          , Rr          , Rr          , Uu^Vu       , Uu          , Uh          , Cud         , Cud         , Uu          , Rr          , Uu          , 4 Kud       , Cud         , Uh          , Uu          , Rr          , Uu^Ii       , Uu^Uf       , Uu^Ii       , Uu          , Uu^Uf       , Xu          , Uu^Uf       , Xu          , Xu          
Xu          , Xu          , Uh          , Uh          , Rd          , Rd          , Rr          , Rr          , Uu^Ii       , Uu          , Uu^Uf       , Uu          , Uu^Uf       , Uu^Uf       , Uu^Vu       , Cud         , Rr          , Cud         , Cud         , Cud         , Uh          , Uh          , Rr          , Uu^Vud      , Uu^Uf       , Uu^Uf       , Uu          , Qxu         , Xu          , Xu          , Xu          , Xu          
Uh          , Uh          , Uh          , Uh          , Rr          , Rr          , Uu^Vud      , Xu          , Uu^Ii       , Uu^Uf       , Uh          , Uh          , Uu^Uf       , Uh          , Uu          , Uu          , Rr          , Uu^Uf       , Uu^Uf       , Uh          , Uh          , Rd          , Rr          , Uu^Uf       , Uu^Ii       , Uu^Uf       , Uu^Vud      , Qxu         , Qxu         , Xu          , Xu          , Xu          
Uu          , Uu          , Rr          , Rr          , Rd          , Uu          , Uh^Ii       , Uu          , Qxu         , Uu          , Uu          , Uu^Uf       , Uh          , Uh          , Rr          , Rd          , Uu          , Uu          , Uu          , Uh          , Uh          , Rd          , Rr          , Uu^Uf       , Uu^Ii       , Uu^Uf       , Uu^Uf       , Uu^Uf       , Uu          , Qxu         , Xu          , Xu          
Rr          , Rr          , Rd          , Rd          , Uu          , Uu          , Uh^Ii       , Uu          , Uu^Uf       , Qxu         , Uu^Uf       , Uu          , Rr          , Rr          , Rr          , Qxu         , Uu^Uf       , Uu^Uf       , Uu^Uf       , Uu^Vu       , Rd          , Rd          , Rr          , Uu          , Uu^Vu       , Uu^Uf       , Uu^Uf       , Uu^Uf       , Uu^Uf       , Qxu         , Xu          , Xu          
Rd          , Rd          , Uu          , Rd          , Uh          , Uh          , Uh^Ii       , Uh^Ii       , Uu^Uf       , Uu^Uf       , Rd          , Rd          , Uu          , Uu          , Rr          , Uu          , Uu^Vud      , Uu^Uf       , Uu^Uf       , Uu          , Uu^Uf       , Uu^Uf       , Uu^Uf       , Rr          , Rr          , Uu          , Uu^Uf       , Uu^Uf       , Qxu         , Qxu         , Xu          , Xu          
Uu          , Uu          , Uu          , Uu^Vud      , Uh          , Uh          , Uh          , Uh^Ii       , Uu^Vu       , Rd          , Uu^Ii       , Uu^Uf       , Uu^Uf       , Uu^Vu       , Rr          , Uu^Ii       , Uu^Ii       , Uu^Uf       , Rd          , Qxu         , Uu^Vud      , Uu^Uf       , Uu^Uf       , Uu          , Rr          , Uu          , Uu          , Uu^Vud      , Uu^Uf       , Qxu         , Xu          , Xu          
Uh          , Uh          , Uh          , Uu^Ii       , Xu          , Xu          , Uu          , Uu^Ii       , Uu^Uf       , Rd          , Uu          , Uu^Uf       , Uu^Uf       , Uu^Ii       , Uu^Uf       , Rr          , Uu^Ii       , Uu^Uf       , Rd          , Qxu         , Uu^Uf       , Uu^Uf       , Uu          , Rd          , Rd          , Rr          , Rr          , Uu^Uf       , Ce          , Qxu         , Qxu         , Qxu         
Xu          , Xu          , Xu          , Xu          , Xu          , Xu          , Uu^Uf       , Uu^Uf       , Uu^Uf       , Rd          , Ce          , Ce          , Ce          , Uu^Uf       , Uu^Ii       , Rr          , Rr          , Uu          , Uu          , Qxu         , Uu^Uf       , Uu^Uf       , Qxu         , Qxu         , Rd          , Qxu         , Ce          , Ce          , 7 Ke        , Ce          , Qxu         , Qxu         
Xu          , Xu          , Xu          , Xu          , Xu          , Uu^Uf       , Re^Uf       , Uu^Uf       , Rd          , Uu^Ii       , Ce          , 5 Ke        , Ce          , Qxu         , Uu^Ii       , Uu^Vud      , Uu          , Rr          , Rr          , Uu          , Uu^Uf       , Rd          , Rd          , Uu^Vud      , Qxu         , Qxu         , Rr          , Uu^Vu       , Ce          , Uu          , Qxu         , Qxu         
Xu          , Xu          , Xu          , Xu          , Re^Uf       , Re^Uf       , Re^Uf       , Uu^Vu       , Rd          , Uu^Ii       , Xu          , Uu^Vud      , Xu          , Uu          , Uu^Uf       , Uu^Uf       , Uu^Ii       , Uu^Ii       , Rr          , Uu^Vu       , Uu^Uf       , Uu          , Rd          , Qxu         , Uu          , Qxu         , Rr          , Rd          , Rd          , Uu          , Uu          , Uu          
Xu          , Xu          , Xu          , Uu^Uf       , Re^Uf       , Re^Uf       , Uu^Uf       , Uu^Uf       , Uu^Uf       , Rd          , Xu          , Xu          , Xu          , Xu          , Xu          , Uu^Uf       , Qxu         , Qxu         , Qxu         , Rr          , Rr          , Uu^Uf       , Uu          , Rd          , Xu          , Uu          , Xu          , Rr          , Rr          , Uu^Vud      , Rr          , Rr          
Xu          , Xu          , Uu          , Uu^Uf       , Rd          , Rd          , Uu^Vud      , Uu^Uf       , Uu^Uf       , Uu^Ii       , Xu          , Xu          , Xu          , Xu          , Xu          , Qxu         , Qxu         , Qxu         , Qxu         , Qxu         , Qxu         , Rr          , Rr          , Rd          , Xu          , Xu          , Xu          , Xu          , Uu          , Rr          , Rr          , Rr          
Xu          , Xu          , Uu          , Uu^Uf       , Rd          , Rd          , Uu          , Uu^Uf       , Uu^Uf       , Uu^Ii       , Xu          , Xu          , Xu          , Xu          , Xu          , Qxu         , Qxu         , Qxu         , Qxu         , Qxu         , Qxu         , Rr          , Rr          , Rd          , Xu          , Xu          , Xu          , Xu          , Uu          , Rr          , Rr          , Rr          
