border_size=1
usage=map

Xu          ,Xu          , Xu          , Xu          , Xu          , Uu          , Uu          , Uh          , Uh          , Uh          , Dd^Dr       , Dd^Dr       , Ce          , Uh^Ii       , Rd          , Re          , Uh          , Uh          , Uu          , Xu          , Rd          , Rd          , Uu          , Xu          , Xu          , Xu          , Xu          , Xu          , Xu          , Xu          , Xu          , Xu          
Xu          ,Xu          , Xu          , Xu          , Xu          , Uu          , Uu          , Uh          , Uh          , Uh          , Dd^Dr       , Dd^Dr       , Ce          , Uh^Ii       , Rd          , Re          , Uh          , Uh          , Uu          , Xu          , Rd          , Rd          , Uu          , Xu          , Xu          , Xu          , Xu          , Xu          , Xu          , Xu          , Xu          , Xu          
Xu          ,Xu          , Xu          , Xu          , Xu          , Qxu         , Qxu         , Uh          , Uu          , Ce          , Dd^Dr       , Dd^Dr       , Dd^Dr       , Dd^Dr       , Re          , Re          , Uh          , Uu          , Uu          , Rd          , Uu          , Uu          , Uh          , Xu          , Uu^Uf       , Xu          , Xu          , Xu          , Xu          , Xu          , Xu          , Xu          
Xu          ,Xu          , Xu          , Xu          , Xu          , Xu          , Qxu         , Qxu         , Re          , Ce          , Re          , Re          , Re          , Re          , Re^Uf       , Re          , Uh          , Uu          , Dd^Dr       , Rd          , Uu          , Uh          , Uh          , Uu          , Uu          , Xu          , Uh^Ii       , Xu          , Xu          , Xu          , Xu          , Xu          
Xu          ,Xu          , Xu          , Xu          , Xu          , Xu          , Qxu         , Qxu         , Re          , Re          , Rd          , Rr          , Uu          , Uu          , Uu          , Uh          , Uu          , Uu          , Uu^Ii       , Rd          , Uu          , Uu          , Re          , Re          , Re          , Uh^Ii       , Uh^Ii       , Xu          , Xu          , Xu          , Xu          , Xu          
Qxu         ,Qxu         , Qxu         , Qxu         , Qxu         , Qxu         , Uu^Ii       , Uu^Ii       , Rd          , Rd          , Rd          , Rd          , Uu^Uf       , Uu          , Uu          , Uh          , Uu          , Uu          , Uu^Ii       , Rd          , Rd          , Uu^Ii       , Re^Uf       , Uu          , Uu          , Uh          , Xu          , Xu          , Xu          , Xu          , Xu          , Xu          
Uu          ,Uu          , Uu          , Uu          , Uu          , Uu          , Dd^Dr       , Uu^Ii       , Rd          , Re^Uf       , Rd          , Rd          , Rd          , Uh          , Uh^Ii       , Uh          , Uh          , Uu^Uf       , Rd          , Re          , Re          , Dd^Dr       , Uu          , Uu          , Uh          , Re          , Xu          , Xu          , Xu          , Xu          , Xu          , Xu          
Rr          ,Rr          , Rd          , Rd          , Rd          , Rr          , Rr          , Uu          , Rd          , Rd          , Re          , Rd          , Rd          , Rr          , Uu^Ii       , Uu^Ii       , Rd          , Rd          , Re          , Rd          , Uu          , Uu          , Uu          , Uh          , Uh^Ii       , Uh^Ii       , Uu          , Dd^Dr       , Xu          , Xu          , Xu          , Xu          
Uu          ,Uu          , Uh          , Uu          , Uu          , Uu          , Uu          , Rr          , Rd          , Uu          , Uu^Uf       , Uu          , Dd^Dr       , Rd          , Rd          , Uu          , Re          , Re          , Re          , Uu          , Uh          , Uh          , Uu          , Uu          , Dd^Dr       , Uh^Ii       , Uu          , Re          , Uh          , Xu          , Xu          , Xu          
Uh          ,Uh          , Re          , Uu          , Re          , Re          , Dd^Dr       , Ce          , Ce          , Rr          , Rd          , Uu          , Uu          , Rd          , Uu^Uf       , Uu          , Uu          , Re          , Re          , Dd^Dr       , Uh          , Uh          , Uu          , Re          , Uu          , Uh          , Uu          , Uh          , Uu^Uf       , Uh          , Xu          , Xu          
Rd          ,Rd          , Uh          , Uu          , Dd^Dr       , Re          , Dd^Dr       , Dd^Dr       , Re          , Uu^Uf       , Uu          , Rd          , Uu          , Rd          , Rd          , Uu          , Rd          , Re          , Re          , Uh          , Uh          , Uu          , Uu          , Re          , Uu^Ii       , Uu          , Uu          , Uh          , Uh          , Uh          , Uu          , Uu          
Uu          ,Uu          , Uh          , Uu          , Re^Uf       , Rd          , Re          , Re          , Uu          , Uu          , Uu          , Rd          , Rr          , Re^Uf       , Rr          , Uu          , Re          , Re^Uf       , Uh          , Re          , Re          , Uu          , Rd          , Uh          , Uu^Vud      , Uu          , Uu          , Dd^Dr       , Dd^Dr       , Uu          , Uu          , Uu          
Xu          ,Xu          , Xu          , Uh          , Uh          , Re          , Re          , Re          , Uu          , Rd          , Uu          , Uu          , Uh          , Rr          , Rd          , Rd          , Re          , Uh          , Uu^Vu       , Uu          , Dd^Dr       , Rd          , Rd          , Uh          , Rd          , Uu          , Uu          , Ce          , Ce          , Uh          , Uh          , Uh          
Xu          ,Xu          , Uh          , Uh          , Dd^Dr       , Uu          , Re          , Re          , Re^Uf       , Rd          , Uu^Vud      , Uu          , Uh          , Uh          , Uu          , Rd          , Rd          , Re          , Ce          , Ce          , Re          , Uu          , Rd          , Rd          , Rd          , Uu          , Uu          , Ce          , Dd^Dr       , Dd^Dr       , Uu          , Uu          
Xu          ,Xu          , Uh          , Uh          , Xu          , Uu          , Uh          , Uh          , Rd          , Rd          , Re^Uf       , Rd          , Uu          , Uh          , Rd          , Rd          , Rd          , Rd          , Ce          , Dd^Dr       , Dd^Dr       , Dd^Dr       , Uu^Uf       , Rd          , Rd          , Rd          , Uu          , Dd^Dr       , Uu          , Uh          , Uh          , Uh          
Xu          ,Xu          , Xu          , Xu          , Xu          , Xu          , Uh          , Uh          , Rr          , Re          , Re          , Re^Uf       , Rr          , Uu          , Re          , Re          , Re          , Dd^Dr       , Rd          , Dd^Dr       , Dd^Dr       , Uu          , Rd          , Rd          , Dd^Dr       , Rd          , Rd          , Rd          , Uu          , Uh          , Rd          , Rd          
Xu          ,Xu          , Xu          , Xu          , Xu          , Xu          , Uh          , Uh          , Rd          , Uu^Uf       , Uh          , Re          , Uu          , Re          , Re          , Rd          , Re          , Re          , Rd          , Rd          , Uu          , Uu          , Uu          , Uu          , Uu          , Uu^Ii       , Uu^Ii       , Rd          , Rr          , Rd          , Rr          , Rr          
Uu          ,Uu          , Rd          , Uu          , Uu          , Xu          , Uu^Ii       , Uh          , Rd          , Uh          , Uh          , Uu          , Uu          , Dd^Dr       , Uh          , Uh          , Rr          , Re          , Uu          , Dd^Dr       , Dd^Dr       , Dd^Dr       , Re          , Uu          , Uh          , Uu^Ii       , Rd          , Rd          , Uu          , Rd          , Uu          , Uu          
Rd          ,Rd          , Uu          , Rd          , Rd          , Rr          , Rr          , Rd          , Uh          , Uh          , Uu          , Uh          , Uu          , Uu          , Uu^Uf       , Uu          , Rr          , Uu          , Uu          , Dd^Dr       , Dd^Dr       , Uh          , Re          , Re          , Rr          , Rr          , Uu          , Uu          , Uh          , Dd^Dr       , Uu          , Uu          
Rd          ,Rd          , Rd          , Uu          , Uu          , Uh          , Uh^Ii       , Rr          , Rd          , Dd^Dr       , Uu          , Uh          , Uu          , Uu          , Rd          , Rd          , Rd          , Rd          , Uu          , Re          , Uu          , Uu          , Re          , Uh          , Rd          , Uu          , Uu          , Uu^Vud      , Uh          , Uu^Uf       , Xu          , Xu          
Rd          ,Rd          , Uu          , Rd          , Rd          , Uh^Ii       , Uh^Ii       , Uu^Ii       , Rd          , Uu          , Uu^Uf       , Uu          , Uu          , Uu^Uf       , Dd^Dr       , Dd^Dr       , Rr          , Cud         , Dd^Dr       , Uu          , Re          , Uu          , Re          , Rd          , Dd^Dr       , Uu          , Uu^Uf       , Uh          , Uu          , Uu          , Xu          , Xu          
Uu          ,Uu          , Uu          , Uu          , Uu^Ii       , Rd          , Uu          , Uu          , Uu          , Rd          , Rd          , Uu          , Cud         , Cud         , Dd^Dr       , Rd          , Ss^Bw|      , Uu          , Dd^Dr       , Dd^Dr       , Dd^Dr       , Re          , Rd          , Rd          , Uu          , Uu          , Uh          , Uu          , Xu          , Xu          , Xu          , Xu          
Uh          ,Uh          , Uh          , Uu          , Uu^Ii       , Rd          , Dd^Dr       , Uu          , Uu          , Uh          , Uh          , Rr          , Rd          , Uu          , Ss          , Ss          , Cud         , Ss          , Ss          , Uu          , Rd          , Rr          , Uu^Vud      , Uu          , Uh          , Uh          , Xu          , Xu          , Xu          , Xu          , Xu          , Xu          
Uh          ,Uh          , Uh          , Uu          , Uu^Uf       , Uu          , Uh          , Uu          , Uu          , Uu^Uf       , Dd^Dr       , Cud         , Uu          , Ss^Bw\      , Dd^Dr       , Cud         , Uu^Cd       , Dd^Dr       , Dd^Dr       , Ss^Bw/      , Uu          , Dd^Dr       , Cud         , Uh          , Uh          , Uh          , Xu          , Xu          , Xu          , Xu          , Xu          , Xu          
Uh          ,Uh          , Uh          , Uh          , Uu^Uf       , Uu          , Uu          , Uu          , Uh          , Dd^Dr       , Dd^Dr       , Dd^Dr       , Uh          , Ss          , Cud         , Uu^Cd       , 1 Uu^Kd     , Uu^Cd       , Cud         , Ss          , Uu          , Dd^Dr       , Dd^Dr       , Uu^Uf       , Xu          , Xu          , Xu          , Xu          , Xu          , Xu          , Xu          , Xu          
Uh          ,Uh          , Uh          , Uh          , Uh          , Uu          , Uh^Ii       , Uh^Ii       , Uu^Uf       , Uu^Uf       , Dd^Dr       , Uu^Uf       , Uh          , Ss          , Cud         , Uu^Cd       , Uu^Cd       , Uu^Cd       , Dd^Dr       , Ss          , Uu^Uf       , Uu          , Dd^Dr       , Uh          , Uu          , Xu          , Xu          , Xu          , Uu^Vu       , Xu          , Uh          , Uh          
Rd          ,Rd          , Rd          , Uu^Uf       , Rd          , Uu          , Uu^Ii       , Uh^Ii       , Uu          , Uh          , Uh          , Cud         , Rd          , Ss^Bw/      , Ss          , Dd^Dr       , Cud         , Dd^Dr       , Ss          , Ss^Bw\      , Rd          , Cud         , Uu          , Dd^Dr       , Rr          , Xu          , Rd          , Uu          , Rd          , Rr          , Rr          , Rr          
Xu          ,Xu          , Uu          , Rd          , Uu^Uf       , Rd          , Rd          , Uu^Ii       , Rd          , Uu          , Rd          , Rd          , Cud         , Uu^Uf       , Dd^Dr       , Ss          , Ss^Bw|      , Ss          , Dd^Dr       , Uu          , Cud         , Rr          , Rd          , Rr          , Uu^Ii       , Rd          , Rr          , Rd          , Uu          , Uu          , Uu^Uf       , Uu^Uf       
Xu          ,Xu          , Xu          , Xu          , Uu          , Uu          , Dd^Dr       , Rd          , Rd          , Rr          , Dd^Dr       , Uu          , Uh          , Cud         , Dd^Dr       , Uu          , Rd          , Uu          , Dd^Dr       , Dd^Dr       , Uh          , Uu          , Rd          , Uu^Ii       , Uu          , Uu^Ii       , Uu          , Uu^Uf       , Xu          , Uu          , Xu          , Xu          
Xu          ,Xu          , Uh          , Uh          , Rd          , Rd          , Rd          , Rd          , Uu^Ii       , Uu          , Uu          , Uu          , Uu          , Uu          , Dd^Dr       , Dd^Dr       , Rd          , Cud         , Cud         , Cud         , Uh          , Uh          , Rr          , Dd^Dr       , Uu          , Uu          , Uu          , Qxu         , Xu          , Xu          , Xu          , Xu          
Uh          ,Uh          , Uh          , Uh          , Rr          , Rr          , Uu^Vud      , Xu          , Uu^Ii       , Uu          , Uh          , Uh          , Uu          , Uh          , Uu          , Uu          , Rr          , Uu^Uf       , Uu^Uf       , Uh          , Uh          , Rd          , Rr          , Uu^Uf       , Uu^Ii       , Uu^Uf       , Dd^Dr       , Qxu         , Qxu         , Xu          , Xu          , Xu          
Uu          ,Uu          , Rd          , Rd          , Rd          , Uu          , Uh^Ii       , Uu          , Qxu         , Uu          , Uu          , Uu^Uf       , Uh          , Uh          , Rd          , Rr          , Uu          , Uu          , Uu          , Uh          , Uh          , Rd          , Ce          , Uu^Uf       , Uu^Ii       , Uu          , Uu          , Uu^Uf       , Uu          , Qxu         , Xu          , Xu          
Rd          ,Rd          , Rd          , Rd          , Uu          , Uu          , Uh^Ii       , Uu          , Uu          , Qxu         , Uu^Uf       , Uu          , Rr          , Rd          , Rd          , Qxu         , Uu^Uf       , Uu          , Uu          , Dd^Dr       , Rd          , Ce          , 2 Ke        , Ce          , Dd^Dr       , Uu^Uf       , Uu          , Uu          , Uu^Uf       , Qxu         , Xu          , Xu          
Rd          ,Rd          , Uu          , Rd          , Uh          , Uh          , Uh^Ii       , Uh^Ii       , Uu          , Uu          , Rd          , Rd          , Uu          , Uu          , Rd          , Uu          , Uu^Vud      , Uu          , Uu          , Ce          , Ce          , Ce          , Ce          , Ce          , Rr          , Uu          , Uu          , Uu^Uf       , Qxu         , Qxu         , Xu          , Xu          
Uu          ,Uu          , Uu          , Uu^Vud      , Uh          , Uh          , Uh          , Uh^Ii       , Dd^Dr       , Rd          , Uu^Ii       , Uu          , Uu          , Dd^Dr       , Rd          , Uu^Ii       , Uu^Ii       , Uu^Uf       , Rd          , Qxu         , Dd^Dr       , Re          , Re          , Re          , Rr          , Uu          , Uu          , Dd^Dr       , Uu^Uf       , Qxu         , Xu          , Xu          
Uh          ,Uh          , Uh          , Uu^Ii       , Xu          , Xu          , Uu          , Uu^Ii       , Uu          , Rd          , Uu          , Uu          , Uu          , Uu^Ii       , Uu          , Rd          , Uu^Ii       , Uu^Uf       , Rd          , Qxu         , Uu          , Uu          , Uu          , Rd          , Rd          , Rd          , Rd          , Uu^Uf       , Re          , Qxu         , Qxu         , Qxu         
Xu          ,Xu          , Xu          , Xu          , Xu          , Xu          , Uu          , Uu          , Uu^Uf       , Rd          , Ce          , Re          , Re          , Uu^Uf       , Uu^Ii       , Rr          , Rr          , Uu          , Uu          , Qxu         , Uu          , Uu          , Qxu         , Qxu         , Rd          , Qxu         , Re          , Re          , Re          , Re          , Qxu         , Qxu         
Xu          ,Xu          , Xu          , Xu          , Xu          , Uu          , Re^Uf       , Uu          , Rd          , Uu^Ii       , Ce          , Re          , Re          , Qxu         , Uu^Ii       , Uu^Vud      , Uu          , Rd          , Rd          , Uu          , Uu          , Rd          , Rd          , Dd^Dr       , Qxu         , Qxu         , Rd          , Dd^Dr       , Re          , Uu          , Qxu         , Qxu         
Xu          ,Xu          , Xu          , Xu          , Re          , Re          , Re          , Dd^Dr       , Rd          , Uu^Ii       , Xu          , Dd^Dr       , Xu          , Uu          , Uu          , Uu          , Uu^Ii       , Uu^Ii       , Rd          , Dd^Dr       , Uu          , Uu          , Rd          , Qxu         , Uu          , Qxu         , Rd          , Rd          , Rd          , Uu          , Uu          , Uu          
Xu          ,Xu          , Xu          , Uu          , Re          , Re          , Uu          , Uu          , Uu          , Rd          , Xu          , Xu          , Xu          , Xu          , Xu          , Uu          , Qxu         , Qxu         , Qxu         , Rd          , Rr          , Uu^Uf       , Uu          , Rd          , Xu          , Uu          , Xu          , Rr          , Rr          , Dd^Dr       , Rr          , Rr          
Xu          ,Xu          , Uu          , Uu          , Rd          , Rd          , Dd^Dr       , Uu          , Uu          , Uu^Ii       , Xu          , Xu          , Xu          , Xu          , Xu          , Qxu         , Qxu         , Qxu         , Qxu         , Qxu         , Qxu         , Rr          , Rr          , Rd          , Xu          , Xu          , Xu          , Xu          , Uu          , Rd          , Rd          , Rd          
Xu          ,Xu          , Uu          , Uu          , Rd          , Rd          , Dd^Dr       , Uu          , Uu          , Uu^Ii       , Xu          , Xu          , Xu          , Xu          , Xu          , Qxu         , Qxu         , Qxu         , Qxu         , Qxu         , Qxu         , Rr          , Rr          , Rd          , Xu          , Xu          , Xu          , Xu          , Uu          , Rd          , Rd          , Rd          
