border_size=1
usage=map

Aa^Fpa      , Aa^Fpa      , Aa^Fpa      , Aa^Fpa      , Aa^Fpa      , Aa^Fpa      , Aa^Fpa      , Aa^Fpa      , Aa^Fpa      , Aa^Fpa      , Aa^Fpa      , Ha          , Ha          , Ha          , Ha          , Aa^Fpa      , Aa^Fpa      , Aa^Fpa      , Ha          , Ha          , Ha          , Ha          , Ha          , Ha          , Aa^Fpa      , Aa^Fpa      , Aa^Fpa      , Aa^Fpa      , Aa^Fpa      , Ha          , Aa          , Aa          , Aa          , Rr          , Aa          , Aa          , Aa          , Aa          , Ha          , Ha          , Ha          , Ha          
Ww          , Aa^Fpa      , Aa^Fpa      , Aa^Fpa      , Aa^Fpa      , Aa          , Gg          , Gs          , Gs          , Aa^Fpa      , Aa          , Aa^Fpa      , Aa^Fpa      , Aa^Fpa      , Aa          , Aa          , Aa          , Aa^Fpa      , Aa^Fpa      , Ha          , Ha          , Ha          , Ha          , Ha          , Aa^Fpa      , Aa^Fpa      , Aa^Fpa      , Aa^Fpa      , Aa^Vha      , Aa          , Ce          , Ce          , Aa^Fpa      , Rr          , Aa^Fpa      , Ce          , Ce          , Aa          , Aa          , Aa          , Aa^Fpa      , Ha          
Ww          , Ww          , Ww          , Aa          , Aa^Fpa      , Aa^Fpa      , Gg          , Gs^Fp       , Aa^Fpa      , Aa          , Aa          , Aa          , Aa          , Aa          , Aa^Fpa      , Aa          , Aa          , Aa          , Aa^Fpa      , Aa^Fpa      , Aa^Fpa      , Aa^Fpa      , Aa^Fpa      , Aa^Fpa      , Aa^Fpa      , Aa^Fpa      , Aa^Fpa      , Aa          , Ai          , Aa          , Aa          , Aa^Fpa      , Rr          , Rr          , Aa          , Ce          , Aa          , Aa^Fpa      , Aa^Vha      , Aa^Fpa      , Aa^Fpa      , Ha          
Wo          , Ww          , Ww          , Aa          , Gs^Fp       , Aa          , Gg          , Gs^Fp       , Gs^Fp       , Aa^Fpa      , Aa^Fpa      , Aa^Fpa      , Aa^Fpa      , Gs          , Gs^Fp       , Aa^Fpa      , Gs          , Gs          , Gs          , Gs          , Gs          , Aa^Fpa      , Gs          , Aa^Fpa      , Aa^Fpa      , Aa^Fpa      , Aa          , Ai          , Ce          , Aa          , Aa^Vha      , Ch          , 2 Kh        , Ch          , Aa^Vha      , Aa^Fpa      , Ce          , Aa^Fpa      , Aa^Fpa      , Aa^Fpa      , Gs^Fp       , Hh          
Ww          , Wo          , Wo          , Ww          , Ww          , Gg          , Ww          , Gs^Fp       , Gg          , Gs^Fp       , Gs^Fp       , Gs^Fp       , Gs          , Gs          , Gs^Fp       , Gs^Fp       , Gs          , Gs          , Rd          , Rp          , Rd          , Gs          , Rp          , Gs          , Gs          , Aa^Fpa      , Aa^Fpa      , Ai          , Ce          , Aa          , Rr          , Ch          , Aa          , Ch          , Rr          , Aa          , Ce          , Aa          , Aa^Fpa      , Aa^Fpa      , Gs^Fp       , Hh          
Aa^Fpa      , Ww          , Ww          , Wo          , Wo          , Ww          , Wo          , Ww          , Ww^Bw/      , Gg          , Ww          , Gs^Fp       , Ww          , Gs          , Gg          , Gs^Fp       , Rd          , Rd          , Gs^Fp       , Gg          , Gg^Vwm      , Rp          , Re^Gvs      , Rp          , Rp          , Aa^Fpa      , Aa          , Aa          , Rr          , Rr          , Aa^Fpa      , Aa          , Aa^Fpa      , Aa          , Aa          , Rr          , Aa          , Aa          , Aa^Fpa      , Gs^Fp       , Gs^Fp       , Gs^Fp       
Aa^Fpa      , Aa^Fpa      , Aa^Fpa      , Ww          , Ww          , Wo          , Ww          , Wo          , Wo          , Ww          , Wo          , Ww          , Ww          , Ww          , Ww^Bw/      , Gg          , Aa^Fpa      , Aa^Fpa      , Gs^Fp       , Gs^Fp       , Re          , Re          , Re^Gvs      , Re          , Gs          , Rd          , Rp          , Rr          , Aa          , Aa          , Ce          , Aa^Fpa      , Ce          , Aa^Vha      , Ce          , Rr          , Rr          , Aa^Fpa      , Aa^Fpa      , Gs^Fp       , Gs^Fp       , Gs^Fp       
Ha          , Aa^Fpa      , Aa^Fpa      , Aa^Fpa      , Aa^Fpa      , Ww^Bw|      , Aa^Fpa      , Ww          , Ww          , Wo          , Ww          , Wo          , Wo          , Ww          , Ww          , Aa          , Aa^Fpa      , Aa^Fpa      , Aa^Fpa      , Gs^Fp       , Re          , Re          , Gg          , Gg          , Rd          , Rp          , Aa          , Aa          , Aa          , Aa          , Aa^Fpa      , Ce          , Aa          , Ce          , Aa          , Aa          , Aa^Fpa      , Rd          , Rd          , Rd          , Rd          , Gs          
Ha          , Aa^Fpa      , Aa          , Aa^Vha      , Aa          , Aa^Fpa      , Aa          , Aa^Fpa      , Aa^Fpa      , Aa^Fpa      , Aa          , Ww^Bw/      , Wo          , Wo          , Ww          , Aa          , Aa          , Aa^Fpa      , Aa^Fpa      , Gs^Fp       , Aa^Fpa      , Gs^Fp       , Gs^Fp       , Rp          , Gs          , Gs          , Aa          , Aa          , Re          , Aa^Fpa      , Gs^Fp       , Aa^Fpa      , Aa^Fpa      , Aa          , Aa^Fpa      , Aa          , Aa^Fpa      , Gs^Fp       , Gg^Fet      , Gs          , Gs          , Rd          
Ha          , Aa          , Aa          , Aa          , Aa          , Aa          , Aa          , Aa          , Rd          , Rd          , Aa^Fpa      , Ai          , Wo          , Wo          , Ww          , Aa          , Ww          , Aa          , Aa          , Aa^Fpa      , Aa^Fpa      , Aa^Fpa      , Gs^Fp       , Rp          , Gs          , Gs          , Re          , Aa          , Aa          , Re          , Gs^Fp       , Gs^Fp       , Aa^Fpa      , Aa^Fpa      , Aa^Fpa      , Aa^Fpa      , Aa^Fpa      , Gs^Fp       , Gs^Fp       , Gs^Fp       , Gs^Fp       , Gs          
Aa^Fpa      , Aa^Fpa      , Aa          , Aa^Fpa      , Aa^Fpa      , Aa^Fpa      , Gg          , Aa          , Aa          , Aa^Fpa      , Aa          , Ai          , Ww          , Wo          , Wo          , Ww          , Wo          , Ww          , Ww          , Aa          , Aa          , Aa^Fpa      , Aa^Fpa      , Rd          , Gs          , Re          , Re          , Aa          , Aa          , Gg          , Gs^Fp       , Gs^Fp       , Gs          , Gs          , Gs          , Aa          , Aa^Fpa      , Gs^Fp       , Gg          , Gs^Fp       , Gs^Fp       , Gs^Fp       
Aa^Fpa      , Aa^Fpa      , Aa^Fpa      , Aa^Fpa      , Aa          , Aa          , Gg          , Aa^Fpa      , Rd          , Aa          , Aa^Fpa      , Aa          , Aa          , Ww          , Ww          , Wo          , Ww          , Wo          , Wo          , Ww          , Ww          , Aa^Fpa      , Aa^Fpa      , Rd          , Rp          , Gs          , Rd          , Re          , Rd          , Gg          , Gg          , Re          , Re          , Re          , Re          , Aa          , Aa          , Gs^Fp       , Gs^Fp       , Gs          , Gs          , Gs^Fp       
Aa^Fpa      , Aa^Fpa      , Aa^Fpa      , Aa^Fpa      , Aa^Fpa      , Gg          , Aa^Fpa      , Aa^Fpa      , Rd          , Aa^Fpa      , Aa^Fpa      , Aa          , Aa          , Aa^Fpa      , Aa          , Ai          , Ai          , Ww          , Ww          , Wo          , Wo          , Ww          , Ww          , Aa^Fpa      , Aa^Fpa      , Rd          , Gs^Fp       , Rd          , Re^Gvs      , Rd          , Rd          , Gg          , Gg          , Re          , Re          , Re          , Gg          , Gs^Fp       , Gs^Fp       , Gs^Fp       , Gs          , Gs^Fp       
Gs          , Aa^Fpa      , Gg^Fet      , Gs^Fp       , Gs^Fp       , Gg          , Gs^Fp       , Aa^Fpa      , Aa^Fpa      , Aa          , Rd          , Aa          , Aa^Fpa      , Aa^Fpa      , Chr         , Ch          , Chr         , Ai          , Ai          , Wo          , Wo          , Wo          , Ww          , Ai          , Aa^Fpa      , Aa^Fpa      , Gs^Fp       , Re          , Re          , Re          , Re          , Rd          , Rd          , Gg          , Gg          , Gs^Fp       , Gs^Fp       , Gs^Fp       , Rd          , Rd          , Rd          , Rd          
Gg          , Gs^Fp       , Ggf         , Gs^Fp       , Ggf         , Gg          , Gs^Fp       , Aa^Fpa      , Aa^Fpa      , Aa          , Aa^Vha      , Rd          , Rd          , Aa^Fpa      , Chr         , 4 Kh        , Ch          , Aa          , Ai          , Ww          , Ww          , Wo          , Ww          , Ai          , Aa^Fpa      , Aa^Fpa      , Aa^Fpa      , Gs^Fp       , Gs^Fp       , Re^Gvs      , Re          , Gg          , Rp          , Gg^Vh       , Ce          , Gs^Fp       , Rd          , Rd          , Gs^Fp       , Gs^Fp       , Gs^Fp       , Gs          
Gg          , Gs^Fp       , Gg          , Gs^Fp       , Gg          , Gs^Fp       , Gs^Fp       , Gs^Fp       , Aa^Fpa      , Aa          , Aa          , Aa^Fpa      , Aa^Fpa      , Aa          , Aa          , Chr         , Aa          , Aa          , Ai          , Ww          , Ww          , Wo          , Ww          , Wwf         , Wwf         , Wwf         , Wwf         , Wwf         , Wwf         , Gg          , Gg          , Gg          , Rd          , Ce          , Rr          , Rd          , Gg          , Gs          , Gs^Fp       , Ha          , Ha          , Ha          
Gs^Fp       , Gg^Vh       , Gs^Fp       , Gg          , Aa          , Gs          , Aa^Fpa      , Aa^Fpa      , Aa          , Aa          , Aa          , Aa          , Aa          , Rd          , Rd          , Aa          , Aa^Fpa      , Aa^Vha      , Aa          , Ai          , Ww          , Wo          , Wo          , Ww          , Ww          , Ww          , Ww          , Ww          , Ww          , Wwf         , Ww          , Gg          , Rr          , Gg          , Ch          , Rr          , Ce          , Gg          , Gs          , Aa^Fpa      , Ha          , Ha          
Gs^Fp       , Gs^Fp       , Aa^Fpa      , Aa          , Aa          , Aa          , Aa^Fpa      , Aa^Fpa      , Aa          , Aa^Fpa      , Aa^Fpa      , Aa^Fpa      , Aa          , Aa          , Rd          , Aa          , Aa^Fpa      , Aa          , Aa^Fpa      , Aa^Fpa      , Aa          , Ww          , Ai          , Wo          , Wo          , Wo          , Wo          , Wo          , Wo          , Ww          , Wo          , Ce          , Rr          , Ch          , 3 Kh        , Gg^Vh       , Ce          , Gg          , Aa^Fpa      , Aa^Fpa      , Aa^Fpa      , Ha          
Gs^Fp       , Gg          , Aa^Fpa      , Aa          , Aa^Fpa      , Aa^Fpa      , Aa^Fpa      , Aa^Fpa      , Aa          , Aa          , Aa^Fpa      , Aa^Fpa      , Aa^Fpa      , Aa^Fpa      , Aa          , Aa          , Rd          , Aa^Fpa      , Aa^Fpa      , Aa          , Aa          , Ai          , Ai          , Ww          , Ww          , Ww          , Ww          , Ww          , Ww          , Wo          , Wo          , Ce          , Gg          , Ch          , Ch          , Rr          , Rr          , Gs          , Aa^Fpa      , Ha          , Ha          , Ha          
Aa          , Aa          , Aa^Fpa      , Aa^Fpa      , Ha          , Aa^Fpa      , Aa^Fpa      , Ha          , Ha          , Aa^Fpa      , Aa^Fpa      , Aa          , Aa          , Aa^Fpa      , Aa^Fpa      , Aa          , Aa          , Rd          , Aa^Fpa      , Aa          , Aa^Fpa      , Aa          , Aa          , Ai          , Aa          , Aa          , Aa^Fpa      , Aa          , Ww          , Wo          , Wo          , Ww          , Ww^Bw/      , Rr          , Gg^Vh       , Rr          , Gs          , Gs          , Aa^Fpa      , Aa^Fpa      , Ha          , Ha          
Aa          , Aa          , Aa^Fpa      , Ha          , Ha          , Ha          , Ha          , Aa^Fpa      , Ha          , Ha          , Ha          , Aa          , Aa          , Aa^Fpa      , Gs^Fp       , Gs^Fp       , Gs^Fp       , Rd          , Aa^Fpa      , Aa^Fpa      , Gs^Fp       , Aa          , Chr         , Aa^Fpa      , Aa^Fpa      , Aa^Fpa      , Aa^Fpa      , Aa          , Ww          , Ww          , Wo^Bw/      , Wo^Bw/      , Ww          , Gg          , Ce          , Ce          , Gs          , Gs          , Gs^Fp       , Aa^Fpa      , Ha          , Ha          
Aa          , Aa^Fpa      , Aa^Fpa      , Ha          , Ha          , Ha          , Aa^Fpa      , Aa^Fpa      , Hh          , Hh          , Ha          , Aa^Fpa      , Aa^Fpa      , Aa^Vha      , Gs^Fp       , Gs^Fp       , Gs          , Rd          , Gs          , Gs^Fp       , Gs^Fp       , Chr         , 5 Khr       , Chr         , Aa^Fpa      , Aa^Fpa      , Aa          , Aa          , Rp          , Ww^Bw/      , Ww          , Wo          , Wo          , Wo          , Wo          , Gs          , Gg^Vwm      , Gs^Fp       , Gs^Fp       , Aa^Fpa      , Ha          , Ha          
Aa^Fpa      , Aa          , Aa^Fpa      , Aa^Fpa      , Ha          , Aa^Fpa      , Aa^Fpa      , Gs^Fp       , Hh          , Hh          , Ha          , Ha          , Aa^Fpa      , Aa          , Aa^Fpa      , Gs^Fp       , Gs          , Gs          , Rd          , Gg          , Gs          , Chr         , Chr         , Chr         , Rp          , Rp          , Rp          , Rp          , Gg          , Gg          , Gg          , Ww          , Wo          , Wo          , Ww          , Ww^Bw|      , Ww          , Gs^Fp       , Aa^Fpa      , Aa^Fpa      , Aa^Fpa      , Ha          
Aa          , Aa          , Ha          , Aa^Fpa      , Ha          , Aa^Fpa      , Aa^Fpa      , Gs^Fp       , Hh          , Ha          , Ha          , Ha          , Aa          , Aa^Fpa      , Aa          , Aa          , Aa          , Gs^Fp       , Aa          , Rd          , Rp          , Gs          , Rp          , Rd          , Gg          , Gg          , Gs          , Gs          , Gs^Fp       , Gs^Fp       , Gs^Fp       , Ww          , Ww          , Wo          , Wo          , Ww          , Ww          , Ww          , Aa          , Aa^Fpa      , Aa^Fpa      , Ha          
Ha          , Aa          , Aa^Fpa      , Aa^Fpa      , Gs^Fp       , Aa^Fpa      , Gs^Fp       , Ha          , Hh          , Ha          , Hh          , Hh          , Gs^Fp       , Aa^Fpa      , Gs^Fp       , Aa          , Aa          , Aa          , Gs^Fp       , Gg          , Rp          , Rp          , Gs^Fp       , Gs          , Gs^Fp       , Gs^Fp       , Gs^Fp       , Gs^Fp       , Aa^Fpa      , Gs^Fp       , Gs^Fp       , Gg          , Ww          , Ww          , Wo          , Wo          , Ww          , Ww          , Aa          , Aa^Fpa      , Aa          , Ha          
Ha          , Ha          , Aa^Fpa      , Gs^Fp       , Gs^Fp       , Aa^Fpa      , Gs^Fp       , Gs^Fp       , Hh          , Ha          , Hh          , Hh          , Gs^Fp       , Gs^Fp       , Gg          , Gs^Fp       , Aa          , Aa          , Gg          , Rp          , Gg          , Gs^Fp       , Aa^Fpa      , Gs^Fp       , Aa^Fpa      , Aa^Fpa      , Aa^Fpa      , Aa^Fpa      , Aa^Fpa      , Aa^Fpa      , Aa^Fpa      , Gs^Fp       , Aa^Fpa      , Ww          , Ww          , Wo          , Ww          , Ww          , Aa^Fpa      , Aa^Fpa      , Ha          , Ha          
Ha          , Aa^Fpa      , Gs^Fp       , Gs^Fp       , Gs^Fp       , Gs^Fp       , Gs^Fp       , Gg^Fet      , Hh          , Hh          , Gs^Fp       , Gs^Fp       , Gs          , Gs          , Gs^Fp       , Gs          , Gg          , Gg          , Gg          , Rd          , Gg          , Aa^Fpa      , Aa          , Aa^Fpa      , Aa          , Aa^Fpa      , Aa          , Aa^Fpa      , Aa          , Aa          , Aa^Fpa      , Gs^Fp       , Aa^Fpa      , Ww          , Wo          , Wo          , Ww          , Ha          , Aa^Fpa      , Ha          , Mm          , Mm^Xm       
Aa^Fpa      , Aa^Fpa      , Gs^Fp       , Gs^Fp       , Gs^Fp       , Gg^Vh       , Gs^Fp       , Gs^Fp       , Gs^Fp       , Gs^Fp       , Gs^Fp       , Gs^Fp       , Gs^Fp       , Gs^Fp       , Gs^Fp       , Gs          , Gs          , Gs^Fp       , Gg^Vwm      , Rd          , Aa^Fpa      , Aa          , Ai          , Aa          , Wo          , Aa^Fpa      , Aa^Fpa      , Aa          , Aa          , Aa          , Aa^Fpa      , Aa^Fpa      , Aa^Fpa      , Ww          , Wo          , Ww          , Ai          , Hh          , Ha          , Mm          , Mm^Xm       , Mm^Xm       
Ha          , Aa^Fpa      , Gs^Fp       , Aa^Fpa      , Gs^Fp       , Gs^Fp       , Aa          , Gs^Fp       , Aa          , Gs^Fp       , Aa          , Aa          , Aa          , Aa^Fpa      , Gs^Fp       , Gs^Fp       , Aa^Fpa      , Gs          , Gs          , Rp          , Aa^Fpa      , Ai          , Ai          , Ai          , Wo          , Ww          , Ww          , Aa^Fpa      , Aa^Fpa      , Aa          , Aa          , Aa^Fpa      , Aa          , Ww          , Ww          , Ww          , Ai          , Hh          , Mm          , Mm^Xm       , Mm^Xm       , Mm^Xm       
Gs^Fp       , Aa^Fpa      , Aa^Fpa      , Aa^Fpa      , Ha          , Ha          , Aa^Fpa      , Aa          , Aa          , Aa^Fpa      , Aa^Fpa      , Aa^Fpa      , Gs          , Aa          , Aa          , Aa^Fpa      , Gs^Fp       , Aa^Fpa      , Gs          , Rp          , Rd          , Aa^Fpa      , Aa^Fpa      , Ai          , Ai          , Wo          , Wo          , Aa^Fpa      , Aa^Fpa      , Aa          , Aa^Fpa      , Aa          , Aa          , Aa          , Ww          , Ai          , Mm          , Mm          , Mm^Xm       , Mm^Xm       , Mm          , Mm^Xm       
Gs^Fp       , Gs^Fp       , Aa^Fpa      , Aa^Fpa      , Ha          , Aa^Fpa      , Aa^Fpa      , Aa^Fpa      , Aa          , Aa          , Aa          , Gs          , Gs          , Aa^Fpa      , Aa          , Aa^Fpa      , Gs^Fp       , Aa^Fpa      , Aa^Fpa      , Rp          , Rp          , Aa^Fpa      , Aa^Fpa      , Ai          , Ai          , Wo          , Ai          , Aa^Fpa      , Aa^Fpa      , Aa^Fpa      , Aa^Fpa      , Aa          , Aa          , Aa          , Ww          , Ai          , Mm^Xm       , Mm^Xm       , Mm^Xm       , Mm^Xm       , Mm          , Mm^Xm       
Gs^Fp       , Gs^Fp       , Gs^Fp       , Ha          , Ha          , Aa^Fpa      , Gs^Fp       , Gs^Fp       , Gs^Fp       , Aa          , Aa          , Gs          , Aa          , Aa          , Aa^Vha      , Gs^Fp       , Gs^Fp       , Aa^Fpa      , Gs          , Gs          , Rp          , Gs          , Gs          , Aa          , Aa^Fpa      , Aa          , Aa          , Aa^Fpa      , Aa          , Aa          , Aa          , Aa          , Aa          , Ai          , Ww          , Hh          , Mm          , Mm^Xm       , Mm          , Mm^Xm       , Mm          , Mm^Xm       
Gs^Fp       , Gs^Fp       , Gs^Fp       , Ha          , Ha          , Ha          , Ha          , Gs^Fp       , Aa^Fpa      , Gs^Fp       , Gs          , Gs          , Aa          , Aa          , Gs^Fp       , Gs^Fp       , Gs^Fp       , Gs          , Rp          , Rp          , Gs^Fp       , Gg          , Gs          , Aa^Fpa      , Aa^Fpa      , Aa          , Aa^Fpa      , Aa^Fpa      , Aa^Fpa      , Aa          , Aa^Fpa      , Aa          , Ww          , Ww          , Hh          , Mm          , Mm          , Mm          , Aa^Fpa      , Aa^Fpa      , Aa^Fpa      , Mm^Xm       
Hh          , Gs^Fp       , Hh          , Hh          , Ha          , Ha^Vhha     , Ha          , Aa^Fpa      , Ce          , Aa^Fpa      , Gs^Fp       , Aa          , Hh          , Gs          , Gs^Fp       , Gs          , Hh          , Rp          , Hh          , Gg          , Gs^Fp       , Gs^Fp       , Aa^Fpa      , Aa^Fpa      , Aa^Fpa      , Aa^Fpa      , Aa^Fpa      , Ha          , Aa^Fpa      , Aa^Fpa      , Ha          , Ha          , Ww          , Ww          , Ww          , Ww          , Ww          , Ai          , Ai          , Aa^Fpa      , Ai          , Ai          
Mm          , Hh          , Mm          , Hh          , Mm          , Ha          , Aa^Fpa      , Ce          , 1 Ke        , Ce          , Gs^Fp       , Gs^Fp       , Ha          , Ha^Vhha     , Hh          , Hh          , Ha          , Hh          , Hh          , Gs^Fp       , Hh          , Gs^Fp       , Gs^Fp       , Aa^Fpa      , Gs^Fp       , Aa^Fpa      , Aa^Fpa      , Ha          , Aa^Fpa      , Aa^Fpa      , Ha          , Ai          , Ww          , Ww          , Mm^Xm       , Ww          , Mm^Xm       , Ww          , Ww          , Ww          , Ww          , Ai          
Mm          , Mm          , Mm          , Mm          , Ha          , Ha          , Aa^Fpa      , Ce          , Ce          , Ce          , Aa^Fpa      , Ha          , Mm          , Ha          , Ha          , Ha          , Ha          , Ha          , Mm          , Hh          , Hh          , Hh          , Gs^Fp       , Gs^Fp       , Aa^Fpa      , Aa^Fpa      , Ha          , Ha          , Aa^Fpa      , Ha          , Mm^Xm       , Ai          , Ww          , Ww          , Mm          , Mm          , Mm          , Mm          , Mm          , Ai          , Mm^Xm       , Ww          
Mm          , Mm^Xm       , Mm          , Ha          , Hh          , Aa^Fpa      , Aa^Fpa      , Hh          , Hh          , Hh          , Ha          , Ha          , Mm          , Mm          , Mm^Xm       , Mm          , Mm          , Mm          , Mm^Xm       , Mm^Xm       , Mm^Xm       , Hh          , Hh          , Hh          , Hh          , Ha          , Ha          , Ha          , Ha          , Mm          , Mm          , Ww          , Ww          , Mm          , Mm          , Mm          , Mm^Xm       , Mm          , Mm          , Mm^Xm       , Mm          , Mm^Xm       
Mm          , Mm^Xm       , Mm          , Mm^Xm       , Mm          , Hh          , Ha          , Mm          , Mm          , Mm          , Ha          , Ha          , Mm          , Mm          , Mm          , Mm          , Mm          , Mm^Xm       , Mm^Xm       , Mm^Xm       , Mm^Xm       , Hh          , Hh          , Hh          , Ha          , Ha          , Mm^Xm       , Ha          , Ha          , Mm          , Mm          , Ww          , Ww          , Mm          , Mm          , Mm^Xm       , Mm          , Mm          , Mm^Xm       , Mm^Xm       , Mm          , Mm^Xm       
Mm          , Mm          , Mm^Xm       , Mm          , Mm          , Ha          , Mm          , Ha          , Mm          , Ha          , Mm          , Mm          , Mm          , Mm          , Mm          , Mm          , Mm          , Mm^Xm       , Mm^Xm       , Mm^Xm       , Mm^Xm       , Mm^Xm       , Mm^Xm       , Mm^Xm       , Mm^Xm       , Mm^Xm       , Mm^Xm       , Mm^Xm       , Mm^Xm       , Mm          , Mm          , Ai          , Ww          , Ww          , Mm^Xm       , Mm^Xm       , Mm^Xm       , Mm          , Mm          , Mm          , Mm^Xm       , Mm^Xm       
Mm          , Mm          , Mm          , Mm          , Mm          , Ha          , Mm^Xm       , Mm          , Mm^Xm       , Mm          , Mm^Xm       , Mm          , Mm^Xm       , Mm^Xm       , Mm^Xm       , Mm^Xm       , Mm^Xm       , Mm^Xm       , Mm^Xm       , Mm^Xm       , Mm^Xm       , Mm^Xm       , Mm^Xm       , Mm^Xm       , Mm^Xm       , Mm^Xm       , Mm^Xm       , Mm^Xm       , Mm^Xm       , Mm^Xm       , Mm^Xm       , Ai          , Ai          , Ww          , Ai          , Mm^Xm       , Mm^Xm       , Mm^Xm       , Mm^Xm       , Mm^Xm       , Mm^Xm       , Mm^Xm       
Mm          , Mm          , Mm          , Mm          , Mm^Xm       , Mm^Xm       , Mm^Xm       , Mm^Xm       , Mm^Xm       , Mm^Xm       , Mm^Xm       , Mm^Xm       , Mm^Xm       , Mm^Xm       , Mm^Xm       , Mm^Xm       , Mm^Xm       , Mm^Xm       , Mm^Xm       , Mm^Xm       , Mm^Xm       , Mm^Xm       , Mm^Xm       , Mm^Xm       , Mm^Xm       , Mm^Xm       , Mm^Xm       , Mm^Xm       , Mm^Xm       , Mm^Xm       , Mm^Xm       , Mm^Xm       , Mm^Xm       , Ww          , Ww          , Mm^Xm       , Mm^Xm       , Mm^Xm       , Mm^Xm       , Mm^Xm       , Mm^Xm       , Mm^Xm       
Mm          , Mm          , Mm          , Mm^Xm       , Mm^Xm       , Mm^Xm       , Mm^Xm       , Mm^Xm       , Mm^Xm       , Mm^Xm       , Mm^Xm       , Mm^Xm       , Mm^Xm       , Mm^Xm       , Mm^Xm       , Mm^Xm       , Mm^Xm       , Mm^Xm       , Mm^Xm       , Mm^Xm       , Mm^Xm       , Mm^Xm       , Mm^Xm       , Mm^Xm       , Mm^Xm       , Mm^Xm       , Mm^Xm       , Mm^Xm       , Mm^Xm       , Mm^Xm       , Mm^Xm       , Mm^Xm       , Mm^Xm       , Ww          , Ww          , Mm^Xm       , Mm^Xm       , Mm^Xm       , Mm^Xm       , Mm^Xm       , Mm^Xm       , Mm^Xm       
