border_size=1
usage=map

Ww          , Ww          , Wo          , Wo          , Wo          , Wo          , Wo          , Ww          , Ww          , Gg          , Gs^Fp       , Gg          , Gs^Fp       , Gs^Fp       , Gs^Fp       , Gs^Fp       , Gs^Fp       , Gg          , Rr          , Gs^Fp       , Gs^Fp       , Gg          , Gs^Fp       , Gs^Fp       , Gs^Fp       , Gs^Fp       , Gs^Fp       , Gs^Fp       , Gs^Fp       , Gs^Fp       , Hh          , Hh          , Gs^Fp       , Rp          , Re^Gvs      , Gg^Wm       , Re^Gvs      , Re^Gvs      , Re^Gvs      , Re^Gvs      , Re^Gvs      , Re^Gvs      
Ww          , Ww          , Ww          , Wo          , Wo          , Wo          , Wo          , Wo          , Wo          , Ww          , Ww          , Gg          , Ce          , Gg          , Gg          , Gs^Fp       , Gs^Fp       , Gs^Fp       , Rp          , Gs^Fp       , Gg          , Gs^Fp       , Gg          , Gg^Vh       , Gg          , Ggf         , Gs^Fp       , Gs^Fp       , Gs^Fp       , Gs^Fp       , Re^Gvs      , Re^Gvs      , Re^Gvs      , Rp          , Gg          , Re^Gvs      , Re^Gvs      , Re^Gvs      , Gg^Wm       , Re^Gvs      , Hh          , Hh          
Ss          , Ww          , Ww          , Ww          , Ww          , Ww          , Ww          , Wo          , Wo          , Wo          , Ww          , Ww          , Ww          , Ce          , Ggf         , Gg          , Rr          , Rp          , Gg          , Rp          , Rp          , Gs^Fp       , Gs^Fp       , Gg          , Gs^Fp       , Gg          , Ggf         , Gs^Fp       , Gg          , Hh          , Gg^Vh       , Re^Gvs      , Rp          , Rp          , Rp          , Rp          , Rp          , Re^Gvs      , Gs^Fp       , Hh          , Hh          , Gs^Fp       
Ss          , Ss          , Gs^Fp       , Ww          , Gs^Fp       , Ww          , Ww          , Wo          , Wo          , Wo          , Wo          , Ww          , Ww          , Ce          , Gg          , Rr          , Gg          , Gg          , Ggf         , Gg          , Gg          , Rp          , Rp          , Gg          , Rp          , Rp          , Rp          , Gg          , Rp          , Gg          , Gs^Fp       , Rp          , Re^Gvs      , Gg^Wm       , Re^Gvs      , Gs^Fp       , Rp          , Hh          , Hh          , Hh          , Rp          , Rp          
Gs^Fp       , Gs^Fp       , Gg          , Gg          , Ggf         , Ggf         , Ss          , Ww          , Ww          , Wo          , Wo          , Ww          , Ww          , Gg          , Rr          , Rp          , Ce          , Gg          , Gg          , Ce          , Ce          , Ggf         , Gg          , Rp          , Gg          , Gg          , Gg          , Rp          , Gg          , Rp          , Rp          , Rp          , Ggf         , Re^Gvs      , Hh          , Hh          , Gs^Fp       , Rp          , Rp          , Rp          , Ggf         , Gs^Fp       
Gg          , Gs^Fp       , Gg          , Ss          , Ss          , Ss          , Ss          , Ww          , Ww          , Wo          , Ww          , Wo          , Wo^Bw/      , Ww^Bw/      , Ww          , Ce          , Ww          , Gg          , Wwf         , Gg          , Ce          , Ggf         , Gg          , Gg          , Gs^Fp       , Gs^Fp       , Hh          , Gs          , Gs^Fp       , Gg          , Gg          , Rd          , Rd          , Hh          , Gg          , Hh          , Gg          , Gg          , Gg          , Gg          , Ss          , Gg          
Gs^Fp       , Gg          , Ss          , Gs^Fp       , Gs^Fp       , Gs^Fp       , Ggf         , Ww          , Ww          , Gs^Fp       , Rp          , Wo^Bw/      , Wo          , Wo          , Wo          , Ww          , Ww          , Wwf         , Wwf         , Wwf         , Ww          , Ce          , Gg          , Gs^Fp       , Gs^Fp       , Ggf         , Gs          , Gs          , Hh          , Hh          , Hh          , Gg          , Gg          , Rd          , Rd          , Gg          , Ss          , Ss          , Gg          , Gg          , Ss          , Gg          
Ss          , Ss          , Ss          , Gs^Fp       , Ss          , Gg^Vc       , Gg          , Gg          , Ww          , Gs^Fp       , Rp          , Gs^Fp       , Ww          , Wo          , Wo          , Wwf         , Ww          , Ww          , Ww          , Ww          , Ww          , Ww          , Ww          , Gg          , Ww          , Gs          , Gs          , Gs          , Gg          , Hh          , Gg          , Gg          , Ss          , Ss          , Rd          , Ss          , Gg          , Gg          , Ce          , Gg^Vc       , Ss          , Ss          
Ss          , Ss          , Gs^Fp       , Ss          , Gs^Fp       , Gs^Fp       , Gg          , Ss          , Ss          , Ww          , Ww^Bw|      , Ww          , Ww          , Ww          , Ww          , Ww          , Wwf         , Ww          , Wwf         , Ww          , Wo          , Ww          , Wo          , Ww          , Ww          , Ww          , Ww          , Gg          , Gg          , Hh          , Gg          , Ss          , Ss          , Gg          , Rr          , Gg^Vc       , Rp          , Ce          , Rr          , Gg          , Gg          , Gg          
Gg          , Ss          , Ggf         , Gs^Fp       , Ce          , Ce          , Ce          , Gg          , Rd          , Ss^Bw/      , Ss          , Ww          , Gg          , Ww          , Hh          , Wwf         , Wwf         , Ww          , Ww          , Wo          , Ww          , Wo          , Wo          , Wo          , Wo          , Wo          , Wo          , Ww          , Ww          , Gg          , Gg          , Gg          , Gg          , Gg          , Ggf         , Rr          , Rp          , Rr          , Rp          , Rp          , Rp          , Ce          
Gg          , Gg^Vc       , Ss          , Gg          , Ce          , 4 Ke        , Ce          , Rd          , Gs          , Gs          , Aa^Fpa      , Gs^Fp       , Gs^Fp       , Hh          , Rd          , Gg          , Rd          , Wwf         , Gs^Fp       , Ww          , Ww          , Ww          , Ww          , Ww          , Ww          , Ww          , Wo          , Wo          , Wo          , Ww          , Ww          , Gg          , Gg          , Gg          , Ce          , Rr          , Rr          , Ce          , 2 Ke        , Ce          , Rp          , Rr          
Gg          , Ss          , Ss          , Gg          , Gg          , Gs          , Rp          , Rd          , Gs          , Gs          , Aa^Fpa      , Ss          , Hh          , Hh          , Ggf         , Gg          , Gs^Fp       , Rd          , Gg          , Gs^Fp       , Ggf         , Gg          , Gs^Fp       , Gs^Fp       , Aa^Fpa      , Ww          , Ww          , Wo          , Ww          , Wo          , Ww          , Ww          , Ss          , Gg          , Ce          , Gg^Vc       , Rr          , Ce          , Ce          , Ce          , Rr          , Rr          
Ss          , Gs^Fp       , Gs^Fp       , Gg^Vc       , Gg          , Gg          , Rp          , Gg^Vc       , Gg          , Gs^Fp       , Gg          , Ss          , Ggf         , Gs^Fp       , Rd          , Hh          , Hh          , Hh          , Ggf         , Gs^Fp       , Gs^Fp       , Gs^Fp       , Gs          , Gs          , Aa^Fpa      , Aa          , Aa          , Ww          , Ww          , Ww          , Wo          , Ww          , Wo          , Ss          , Ss          , Gg          , Ggf         , Rp          , Rr          , Rp          , Gg^Vc       , Ggf         
Hh          , Ss          , Gs^Fp       , Ggf         , Gs^Fp       , Ss          , Gs^Fp       , Rp          , Ss^Bw\      , Gg          , Ss          , Gg          , Rd          , Rd          , Hh          , Gg          , Ggf         , Hh          , Gs^Fp       , Gg          , Gs          , Gs^Fp       , Gs          , Aa^Fpa      , Aa^Fpa      , Aa          , Aa^Fpa      , Aa^Fpa      , Aa^Fpa      , Ww          , Wo          , Wo          , Wo          , Wo          , Ss          , Gg          , Gg          , Ce          , Ce          , Rr          , Gg          , Ce          
Ha          , Ss          , Gs          , Gs          , Gs^Fp       , Gs^Fp       , Ss          , Ss          , Ss          , Ss^Bw|      , Ss          , Rd          , Gs^Fp       , Hh          , Hh          , Rd          , Gs^Fp       , Gs^Fp       , Gs^Fp       , Gs^Fp       , Gs          , Gs^Fp       , Gs^Fp       , Aa^Fpa      , Aa          , Aa          , Aa^Fpa      , Aa^Fpa      , Aa^Fpa      , Ww          , Ww          , Wo          , Wo          , Wo          , Wo          , Ww          , Ww          , Gg          , Rr          , Rr          , Ss          , Gg          
Aa^Fpa      , Ha          , Aa^Fpa      , Gs          , Aa          , Aa^Fpa      , Aa^Fpa      , Ss          , Gs^Fp       , Rd          , Rd          , Rd          , Gs          , Gs          , Gg          , Hh          , Hh          , Gs^Fp       , Gs          , Gs          , Gs          , Gs          , Gs^Fp       , Gs^Fp       , Gs          , Gg          , Aa^Fpa      , Aa^Fpa      , Ai          , Ha          , Aa          , Ww          , Chs         , Ss          , Wo          , Wo          , Wo          , Ww^Bw/      , Ww          , Ggf         , Ss          , Ss          
Aa^Fpa      , Aa^Fpa      , Ha          , Aa          , Ha          , Ha          , Hh          , Hh          , Hh          , Gs^Fp       , Rd          , Gs          , Gg          , Hh          , Gg          , Hh          , Gs^Fp       , Gs^Fp       , Gs^Fp       , Gs^Fp       , Gs^Fp       , Gs          , Gs^Fp       , Gs          , Gs          , Gg          , Aa^Fpa      , Ai          , Ai          , Ha          , Aa^Fpa      , Ss          , Ss          , Ss          , Ss^Bw/      , Wo^Bw/      , Wo          , Wo          , Wo          , Ww          , Ss          , Ss          
Ha          , Ha          , Ha          , Aa          , Aa^Fpa      , Gg          , Hh          , Ggf         , Gg          , Rp          , Aa^Fpa      , Gg          , Ha          , Ha          , Gg          , Gg          , Gs^Fp       , Ggf         , Gs^Fp       , Chr         , Gs^Fp       , Gs^Fp       , Gg          , Gs          , Chr         , Gs^Fp       , Ha          , Ha          , Ai          , Ai          , Ai          , Ai          , Rr          , Rd          , Aa          , Ss          , Wo          , Wo          , Ai          , Ww          , Ww          , Gg          
Gs          , Hh          , Gs          , Aa^Fpa      , Gg          , Gg          , Hh          , Hh          , Hh          , Rp          , Aa^Fpa      , Aa^Fpa      , Aa          , Ha          , Gs^Fp       , Gg          , Ss          , Gs^Fp       , Gs^Fp       , Gs^Fp       , Gs^Fp       , Gs^Fp       , Gs^Fp       , Gg          , Gs^Fp       , Gs^Fp       , Ha          , Ha          , Aa          , Aa          , Ai          , Ai          , Rr          , Aa          , Ai          , Ai          , Ai          , Ai          , Wo          , Wo          , Wo          , Ww          
Gs^Fp       , Gs^Fp       , Gs^Fp       , Gs          , Gg          , Gs^Fp       , Gs^Fp       , Hh          , Rp          , Rp          , Gs^Fp       , Aa^Fpa      , Aa          , Aa^Fpa      , Gg          , Ss          , Ss          , Ggf         , Gg          , Gs^Fp       , Gs^Fp       , Gs^Fp       , Chr         , Gg          , Gg          , Gs^Fp       , Hh          , Hh          , Aa          , Aa          , Aa          , Rr          , Rd          , Aa          , Ai          , Ai          , Ai          , Ai          , Wo          , Wo          , Wo          , Wo          
Gs          , Gs^Fp       , Gs          , Gs^Fp       , Gg^Vh       , Gs^Fp       , Gs^Fp       , Gs^Fp       , Gg          , Rp          , Gg          , Gg          , Gg          , Gg          , Ss          , Ss^Vhs      , Ggf         , Gg          , Gs^Fp       , Ss          , Gs^Fp       , Gs^Fp       , Khr         , Chr         , Gg          , Gg          , Hh          , Hh^Vhh      , Hh          , Hh          , Aa^Fpa      , Re          , Ha          , Ha          , Ha          , Aa          , Aa          , Ai          , Ww          , Chw         , Wo          , Wo          
Hh          , Hh          , Hh          , Gs          , Gs^Fp       , Gs^Fp       , Ggf         , Ggf         , Gg          , Ggf         , Gs^Fp       , Gs^Fp       , Gs^Fp       , Gg          , Ggf         , Ss          , Gg          , Chr         , Ss          , Ss          , Ss          , Chr         , Chr         , Gs^Fp       , Ha          , Ha          , Gs^Fp       , Hh          , Gs          , Aa^Fpa      , Aa^Fpa      , Rr          , Hh          , Ha          , Hh          , Aa          , Aa^Fpa      , Aa          , Aa          , Ww          , Ai          , Wo          
Aa          , Hh          , Hh          , Hh          , Gs^Fp       , Gs^Fp       , Gg          , Gs^Fp       , Gs^Fp       , Gs^Fp       , Gs^Fp       , Gs^Fp       , Gs^Fp       , Gg          , Gg          , Gg          , Gg          , Ss          , Aa          , Ss          , Gs^Fp       , Gs^Fp       , Gs^Fp       , Gs^Fp       , Ha          , Aa          , Gs^Fp       , Hh          , Hh          , Hh          , Gs          , Rr          , Gg          , Hh          , Hh          , Aa          , Ha^Vhha     , Aa          , Aa^Fpa      , Ai          , Aa          , Ai          
Aa^Fpa      , Aa^Fpa      , Gs^Fp       , Gs^Fp       , Aa^Fpa      , Gs          , Gg          , Gs^Fp       , Aa          , Aa^Fpa      , Gs^Fp       , Gs^Fp       , Ggf         , Gg          , Gs^Fp       , Gs^Fp       , Aa^Fpa      , Aa          , Aa^Fpa      , Gs^Fp       , Aa^Fpa      , Aa^Fpa      , Aa^Fpa      , Ha          , Aa          , Aa          , Aa^Fpa      , Gs          , Gs          , Hh          , Rd          , Rr          , Hh          , Ha          , Aa^Fpa      , Ha          , Gs          , Hh          , Aa^Fpa      , Ai          , Aa^Fpa      , Aa          
Aa          , Aa^Fpa      , Gs^Fp       , Gs^Fp       , Gs^Fp       , Aa          , Gs          , Aa          , Gs          , Aa^Fpa      , Gs^Fp       , Gs^Fp       , Gg          , Gg          , Gg          , Aa^Fpa      , Aa^Fpa      , Aa^Vea      , Aa^Fpa      , Aa^Fpa      , Aa^Fpa      , Aa^Fpa      , Aa^Fpa      , Aa          , Aa          , Aa^Fpa      , Aa^Fpa      , Gs          , Re          , Rd          , Rd          , Re          , Hh          , Ha          , Aa^Fpa      , Aa^Fpa      , Gs          , Gs          , Gg          , Aa^Fpa      , Ai          , Ai          
Aa          , Aa^Fpa      , Aa^Fpa      , Gs^Fp       , Gs^Fp       , Gs^Fp       , Gs          , Gs          , Gs          , Aa^Fpa      , Aa^Fpa      , Aa^Fpa      , Aa          , Gg          , Aa^Fpa      , Aa^Fpa      , Aa          , Aa^Fpa      , Aa^Fpa      , Aa^Fpa      , Aa^Fpa      , Aa^Fpa      , Gs^Fp       , Aa          , Gg          , Ha          , Aa^Fpa      , Gs          , Rp          , Rp          , Hh          , Gs          , Aa^Fpa      , Aa^Fpa      , Gs^Fp       , Gs          , Hh          , Hh          , Gs^Fp       , Aa^Fpa      , Ai          , Aa          
Aa          , Aa          , Aa          , Aa^Fpa      , Gg          , Gs^Fp       , Gg          , Gg          , Gs^Fp       , Chr         , Gs^Fp       , Aa          , Aa          , Aa          , Aa^Fpa      , Aa^Fpa      , Aa          , Aa^Fpa      , Aa          , Aa          , Aa          , Aa          , Gg          , Gg          , Gs          , Ha          , Hh          , Rp          , Gg          , Gg          , Hh          , Hh          , Aa^Fpa      , Gg          , Ss          , Gg          , Ss          , Hh          , Ggf         , Aa^Fpa      , Aa          , Aa          
Aa          , Aa          , Gs^Fp       , Aa          , Gs^Fp       , Gg          , Gg          , Gs^Fp       , Gs^Fp       , Gs^Fp       , Gs^Fp       , Gg^Ve       , Gg          , Aa          , Gs^Fp       , Aa^Fpa      , Gs^Fp       , Aa          , Aa          , Gs          , Gs          , Gs^Fp       , Gs^Fp       , Gg          , Gs          , Hh          , Rp          , Rp          , Ha          , Ggf         , Gs^Fp       , Gs          , Gs^Fp       , Ss          , Ss          , Ss          , Ss          , Ss          , Gg          , Ggf         , Gg          , Gs^Fp       
Aa^Fpa      , Aa^Fpa      , Aa^Fpa      , Gs^Fp       , Gs^Fp       , Gs^Fp       , Hh          , Gs^Fp       , Gs^Fp       , Gs          , Gs          , Gg          , Aa          , Gg          , Gs^Fp       , Gg^Fet      , Gs^Fp       , Gs          , Aa          , Gs          , Gs          , Gg          , Gs^Fp       , Gs^Fp       , Gs          , Gs          , Gs          , Gg          , Ha          , Ha          , Hh          , Gs^Fp       , Gs^Fp       , Gg          , Gs^Fp       , Gg          , Gs^Fp       , Gg          , Hh          , Gg          , Hh          , Gs^Fp       
Aa^Fpa      , Aa^Fpa      , Gs^Fp       , Gs^Fp       , Aa^Fpa      , Aa^Fpa      , Hh          , Hh          , Gs^Fp       , Gs^Fp       , Gs          , Gg          , Gg          , Gg          , Gs          , Gs^Fp       , Gg          , Gs          , Gs          , Gs          , Gs^Fp       , Gg          , Gg          , Gg          , Hh          , Gg          , Gg          , Gs^Fp       , Aa^Fpa      , Ha          , Hh          , Aa^Fpa      , Gs^Fp       , Ggf         , Aa^Fpa      , Aa^Fpa      , Gs^Fp       , Hh          , Ha          , Hh          , Gs^Fp       , Gs^Fp       
Aa^Fpa      , Aa^Fpa      , Aa^Fpa      , Gs^Fp       , Aa          , Aa          , Ha          , Hh          , Gs          , Gs          , Gs^Fp       , Gs          , Gg          , Gg          , Ww          , Gs          , Ww          , Gg          , Gs^Fp       , Gs^Fp       , Gs^Fp       , Chr         , Hh          , Hh          , Hh          , Hh          , Gs^Fp       , Ggf         , Aa^Fpa      , Aa^Fpa      , Gg          , Aa^Fpa      , Ha          , Gs^Fp       , Aa^Fpa      , Aa^Fpa      , Aa^Fpa      , Gs^Fp       , Gs^Fp       , Gs^Fp       , Gs^Fp       , Gs^Fp       
Aa          , Aa          , Aa          , Aa          , Aa          , Aa          , Ha          , Ha          , Aa^Vha      , Gs          , Gs^Fp       , Gs^Fp       , Ww          , Ww          , Wo          , Ww          , Ww          , Ww          , Ww          , Gg^Fet      , Aa^Fpa      , Gs^Fp       , Ha          , Ha          , Ha          , Ha          , Aa          , Gs^Fp       , Gs^Fp       , Gs^Fp       , Gg          , Aa          , Ha          , Ha          , Aa^Fpa      , Aa^Fpa      , Aa^Fpa      , Gs^Fp       , Ha          , Gs^Fp       , Aa^Fpa      , Aa^Fpa      
Aa          , Aa          , Aa          , Aa          , Aa^Fpa      , Aa^Fpa      , Aa          , Ha          , Aa^Fpa      , Gs          , Gs          , Gs^Fp       , Aa          , Ai          , Ai          , Ai          , Wo          , Ww          , Aa^Fpa      , Gs^Fp       , Aa^Fpa      , Aa^Fpa      , Aa          , Ha          , Ha          , Aa          , Ha          , Aa          , Aa          , Gs^Fp       , Gs^Fp       , Aa          , Ha          , Ha^Vhha     , Ha          , Aa^Fpa      , Ha          , Ha          , Ha          , Ha          , Ha          , Ha          
Ha          , Aa          , Aa          , Aa          , Aa          , Aa^Fpa      , Aa^Fpa      , Aa          , Aa^Fpa      , Aa^Fpa      , Gs          , Gs          , Aa          , Ai          , Ww^Bw/      , Ai          , Aa          , Ww          , Aa^Fpa      , Aa^Fpa      , Aa          , Aa^Fpa      , Aa^Fpa      , Aa          , Ha          , Ha          , Mm^Xm       , Ha          , Ha          , Aa          , Aa^Fpa      , Aa^Fpa      , Aa          , Aa          , Mm          , Mm          , Mm          , Mm^Xm       , Mm^Xm       , Mm^Xm       , Mm          , Ha          
Ha          , Ha          , Ha          , Aa          , Aa          , Aa^Fpa      , Aa          , Aa          , Aa          , Aa^Fpa      , Aa          , Gs          , Gs          , Aa          , Aa          , Aa          , Aa^Vea      , Aa^Fpa      , Aa          , Aa          , Ha          , Aa          , Aa^Fpa      , Aa^Fpa      , Ha          , Mm          , Mm          , Mm          , Aa^Fpa      , Aa          , Aa^Fpa      , Aa^Fpa      , Aa^Fpa      , Ha          , Mm          , Mm          , Mm          , Mm^Xm       , Mm^Xm       , Mm          , Mm          , Mm          
Mm          , Ha          , Ha          , Aa          , Ha          , Aa          , Ha          , Aa          , Ha^Vhha     , Aa^Fpa      , Aa          , Gs          , Aa          , Aa          , Ha          , Aa^Fpa      , Ha          , Aa          , Mm^Vhh      , Ha          , Ha          , Ha          , Aa          , Aa^Fpa      , Aa          , Ha          , Ha          , Ha          , Aa^Fpa      , Aa^Fpa      , Aa          , Aa          , Ha          , Mm          , Mm          , Mm^Xm       , Mm^Xm       , Mm          , Mm          , Mm          , Mm^Xm       , Mm^Xm       
Mm          , Mm^Xm       , Ha          , Ha          , Ha          , Aa^Fpa      , Aa^Fpa      , Mm          , Gs^Fp       , Gs^Fp       , Aa^Fpa      , Aa          , Aa          , Ha          , Aa          , Gs^Fp       , Aa^Fpa      , Mm          , Mm          , Mm^Xm       , Ha          , Aa          , Ha          , Aa^Fpa      , Aa^Fpa      , Aa          , Aa          , Aa          , Ha          , Aa          , Ha          , Aa          , Ha          , Mm          , Mm^Xm       , Mm          , Mm          , Mm          , Ai          , Ai          , Mm          , Mm          
Mm          , Mm^Xm       , Mm^Xm       , Ha          , Ha          , Mm^Xm       , Mm          , Gs^Fp       , Aa^Fpa      , Gs^Fp       , Aa^Fpa      , Gs          , Gs          , Aa          , Gs^Fp       , Gs^Fp       , Aa^Fpa      , Aa^Fpa      , Mm          , Mm^Xm       , Mm^Xm       , Mm          , Ha          , Ha          , Ha          , Aa          , Aa          , Ha          , Mm          , Ha          , Ha          , Ha          , Mm          , Mm^Xm       , Mm          , Mm          , Mm          , Ai          , Ai          , Ai          , Ai          , Mm          
Mm          , Mm^Xm       , Mm^Xm       , Mm^Xm       , Mm          , Mm^Xm       , Gs^Fp       , Gs^Fp       , Ce          , Ce          , Ce          , Ha          , Aa          , Gs          , Gs^Fp       , Aa^Fpa      , Mm          , Mm          , Mm          , Mm^Xm       , Mm^Xm       , Mm          , Mm          , Ha          , Ha          , Ha          , Ha          , Ha          , Mm^Xm       , Mm          , Mm          , Mm          , Mm          , Mm^Xm       , Mm          , Mm          , Ai          , Ai          , Ai          , Ai          , Ai          , Mm          
Mm          , Mm^Xm       , Mm^Xm       , Mm          , Ha          , Hh          , Aa^Fpa      , Hh          , Ce          , 1 Ke        , Ce          , Aa          , Aa^Fpa      , Aa          , Gs          , Gs^Fp       , Hh          , Mm          , Mm^Xm       , Mm^Xm       , Mm^Xm       , Mm^Xm       , Mm          , Mm          , Ha          , Mm          , Mm^Xm       , Mm          , Mm          , Mm^Xm       , Mm          , Mm          , Mm^Xm       , Mm^Xm       , Mm^Xm       , Mm          , Mm          , Ai          , Ai          , Ai          , Mm^Xm       , Mm          
Mm          , Mm          , Mm^Xm       , Mm          , Mm          , Mm          , Aa^Fpa      , Aa^Fpa      , Aa          , Ce          , Aa^Fpa      , Aa          , Aa^Fpa      , Aa          , Gs          , Aa^Fpa      , Gg          , Mm          , Mm^Xm       , Mm^Xm       , Mm^Xm       , Mm^Xm       , Mm          , Mm          , Mm          , Mm          , Mm^Xm       , Mm          , Mm^Xm       , Mm^Xm       , Mm          , Mm          , Mm^Xm       , Mm^Xm       , Mm^Xm       , Mm          , Mm          , Ai          , Mm^Xm       , Mm          , Mm          , Mm          
Mm          , Mm^Xm       , Mm^Xm       , Mm^Xm       , Ha          , Ha          , Aa^Fpa      , Aa          , Gs          , Aa          , Aa          , Aa^Fpa      , Gs          , Gs          , Aa^Fpa      , Aa^Fpa      , Mm          , Mm          , Mm^Xm       , Mm^Xm       , Mm^Xm       , Mm^Xm       , Mm^Xm       , Mm^Xm       , Mm^Xm       , Mm^Xm       , Mm^Xm       , Mm^Xm       , Mm^Xm       , Mm^Xm       , Mm^Xm       , Mm          , Mm          , Mm          , Mm          , Mm          , Mm^Xm       , Mm          , Mm^Xm       , Mm^Xm       , Mm          , Mm          
