border_size=1
usage=map

Aa^Fpa      , Aa          , Aa^Fpa      , Aa          , Aa^Fpa      , Aa^Fpa      , Aa^Fpa      , Aa          , Aa          , Aa          , Aa          , Aa          , Aa          , Ha          , Ha          , Ha          , Mm          , Mm          , Mm          , Mm          , Mm          , Mm          , Aa^Fpa      , Aa^Fpa      , Aa^Fpa      , Aa          , Ai          , Ha          , Mm          , Mm          , Mm          , Mm          
Aa^Fpa      , Aa          , Aa          , Aa          , Aa          , Aa^Fpa      , Aa          , Aa          , Ce          , Ce          , Aa^Fpa      , Aa^Fpa      , Aa          , Ha          , Aa^Fpa      , Ha          , Mm          , Mm          , Mm          , Mm          , Mm          , Ha          , Ha          , Aa^Fpa      , Aa          , Aa^Fpa      , Ai          , Aa^Fpa      , Ha          , Mm          , Aa^Fpa      , Mm          
Aa          , Aa          , Aa^Fpa      , Aa          , Aa          , Aa          , Aa          , Aa          , Aa          , Ke          , Gg          , Aa^Fpa      , Aa          , Aa^Fpa      , Aa^Fpa      , Aa          , Aa          , Aa^Fpa      , Ha          , Mm          , Mm          , Aa^Fpa      , Ha          , Aa^Fpa      , Ww          , Ww          , Ch          , Aa^Fpa      , Ha          , Ha          , Ha          , Ha          
Aa          , Aa          , Aa^Fpa      , Aa^Fpa      , Gs^Fp       , Aa          , Aa          , Gg          , Gg          , Rr          , Gg          , Gg          , Aa          , Gg          , Gg          , Ha          , Ha          , Aa          , Ha          , Ha          , Ha          , Ha          , Aa          , Aa          , Aa^Fpa      , Ai          , Kh          , Ha          , Mm          , Aa^Fpa      , Aa^Fpa      , Mm          
Gg          , Gg          , Aa          , Gs^Fp       , Aa^Fpa      , Gg          , Gg          , Aa          , Aa          , Rr          , Gg          , Aa          , Aa          , Gg          , Gg          , Ha          , Aa          , Aa^Fpa      , Aa          , Aa          , Aa          , Ha          , Aa          , Aa^Fpa      , Ai          , Ww          , Aa          , Ha          , Mm          , Mm          , Mm          , Mm          
Aa          , Gg          , Gg          , Aa          , Gs^Fp       , Aa          , Gs^Fp       , Gs^Fp       , Aa^Fpa      , Gs^Fp       , Rr          , Gg          , Aa^Fpa      , Gg          , Gg          , Gg          , Gg          , Aa          , Aa^Fpa      , Gg          , Gg          , Aa          , Wo          , Wo          , Aa          , Aa          , Aa^Fpa      , Ha          , Aa^Fpa      , Mm          , Mm          , Mm          
Aa          , Gs^Fp       , Gs^Fp       , Aa          , Ha          , Aa          , Aa          , Gs^Fp       , Aa^Fpa      , Aa^Fpa      , Gg          , Gg          , Aa^Fpa      , Aa          , Gs^Fp       , Gs^Fp       , Aa^Fpa      , Aa^Fpa      , Aa^Fpa      , Aa          , Gg          , Gg          , Wo          , Aa          , Ha          , Aa^Fpa      , Mm          , Mm          , Mm          , Mm          , Mm          , Mm          
Ha          , Aa^Fpa      , Aa^Fpa      , Gg          , Ha          , Aa          , Gg          , Gg          , Gg          , Gg          , Rr          , Aa          , Gg          , Gs^Fp       , Aa          , Gs^Fp       , Aa          , Gg          , Gg          , Aa^Fpa      , Aa          , Wo          , Gg          , Gg          , Ha          , Ha          , Mm          , Ha          , Ha          , Mm          , Mm          , Mm          
Mm^Xm       , Ha          , Mm^Xm       , Ha          , Mm^Xm       , Ha          , Hh          , Gg          , Gg          , Gg          , Aa          , Rr          , Gg          , Gg          , Ha          , Aa          , Gg          , Gg          , Gg          , Aa          , Wo          , Wo          , Aa          , Aa          , Mm          , Mm          , Ha          , Ha          , Mm          , Mm          , Mm          , Mm          
Ha          , Mm^Xm       , Ha          , Mm^Xm       , Mm^Xm       , Ha          , Hh          , Gg          , Gg          , Aa          , Ha          , Rr          , Rp          , Gg          , Hh          , Gg          , Gg          , Hh          , Gg          , Gg          , Wo          , Aa^Fpa      , Aa^Fpa      , Ha          , Ha          , Mm          , Ha          , Mm          , Mm          , Mm          , Mm          , Mm          
Ch          , Ha          , Gg          , Hh          , Mm^Xm       , Mm^Xm       , Mm^Xm       , Hh          , Hh          , Gg          , Gg          , Hh          , Rp          , Gg          , Hh          , Hh          , Gg          , Gg          , Gg          , Gg          , Wo          , Gs^Fp       , Gs^Fp       , Gg          , Aa          , Aa          , Aa          , Mm          , Ha          , Mm          , Ha          , Mm          
Ch          , Kh          , Gg          , Hh          , Hh          , Mm^Xm       , Hh          , Mm^Xm       , Mm^Xm       , Gg          , Hh          , Hh          , Rd          , Gg          , Gs^Fp       , Gs^Fp       , Gg          , Gs^Fp       , Gs^Fp       , Wo          , Gg          , Gs^Fp       , Gs^Fp       , Gg          , Gg          , Hh          , Hh          , Aa          , Hh          , Ha          , Ha          , Mm          
Gg^Vh       , Ch          , Rd          , Gg^Vh       , Gg          , Hh          , Gg          , Hh          , Mm^Xm       , Mm^Xm       , Hh          , Gs          , Rd          , Gg          , Hh          , Gs^Fp       , Gs^Fp       , Gs^Fp       , Wo          , Wo          , Gg          , Hh          , Hh          , Gg          , Hh          , Hh          , Gs^Fp       , Hh          , Hh          , Ha          , Hh          , Hh          
Gg          , Gg          , Gg          , Rd          , Rr          , Gg          , Rd          , Hh          , Hh          , Mm^Xm       , Hh          , Gs          , Rd          , Gs          , Gs^Fp       , Gs          , Gs^Fp       , Gs^Fp       , Wo          , Gs^Fp       , Gs^Fp       , Hh          , Gg          , Gg          , Gs^Fp       , Hh          , Gg          , Gs^Fp       , Gg          , Gg          , Gg          , Gg          
Hh          , Hh          , Hh          , Hh          , Hh          , Rd          , Rr          , Rd          , Rr          , Gg          , Gg          , Gg          , Rp          , Gg          , Gg          , Gs          , Gg          , Wo          , Gs^Fp       , Gg          , Gg          , Gg          , Gg          , Gg          , Gg          , Hh          , Gg          , Gg          , Gg          , Gg          , Gg          , Gg          
Mm^Xm       , Mm          , Mm          , Hh          , Hh          , Hh          , Gg          , Hh          , Gs          , Rr          , Rd          , Ch          , Kh          , Gg          , Gs          , Gg          , Gg          , Wo          , Gs^Fp       , Hh          , Gg          , Gs^Fp       , Gg          , Gs^Fp       , Gg          , Gg          , Gg          , Gg          , Gs^Fp       , Ss          , Gg          , Gg          
Mm^Xm       , Mm^Xm       , Mm^Xm       , Mm^Xm       , Mm          , Hh          , Mm          , Gg          , Gs          , Gs          , Gg          , Ch          , Gg          , Gg          , Gs          , Gs          , Gg          , Wo          , Gg          , Gg          , Gg          , Gg          , Re          , Gg          , Rd          , Gg          , Gg^Vc       , Gs^Fp       , Ss          , Gs^Fp       , Gs^Fp       , Gs^Fp       
Mm          , Mm^Xm       , Mm          , Mm^Xm       , Mm^Xm       , Mm^Xm       , Mm^Xm       , Hh          , Hh          , Gs          , Gg          , Rd          , Gg          , Gs          , Gs^Fp       , Gg          , Gg          , Wo          , Gg          , Ggf         , Rd          , Rd          , Gg          , Rd          , Gg          , Re          , Re          , Ce          , Kh          , Gs^Fp       , Ss          , Ss          
Hh          , Mm          , Hh          , Mm          , Mm^Xm       , Mm          , Mm          , Hh          , Gs          , Gg          , Gg          , Rd          , Re          , Gg          , Gg          , Gg          , Wo          , Ww          , Gs^Fp       , Rd          , Gs^Fp       , Gg          , Ggf         , Gg          , Gg          , Ss          , Ss          , Ce          , Ch          , Gg^Vc       , Gg          , Gg          
Ds          , Ds          , Ss          , Hh          , Hh          , Mm          , Mm          , Hh          , Gs          , Gs          , Gs          , Gg          , Gs^Fp       , Re          , Rd          , Gg          , Ww          , Gs^Fp       , Gs^Fp       , Rd          , Gg          , Gg          , Gg          , Gg          , Gg          , Ss          , Gs^Fp       , Gs^Fp       , Gs^Fp       , Gs^Fp       , Gs^Fp       , Gs^Fp       
Gg^Vc       , Gg          , Ss          , Ss          , Gs          , Gs          , Ss          , Gg          , Gg          , Gs          , Gg          , Gg          , Rd          , Rd          , Gg          , Ww          , Rd          , Gs^Fp       , Re          , Rd          , Ggf         , Gg          , Gg          , Gg          , Gs^Fp       , Gg          , Gg          , Gs^Fp       , Gs^Fp       , Ss          , Gs^Fp       , Gs^Fp       
Hd          , Gs          , Ds          , Ss          , Gg          , Gg          , Re          , Rd          , Rd          , Re          , Rd          , Rd          , Gg          , Gg          , Wo          , Wo          , Gg          , Re          , Re          , Gg          , Gg          , Ggf         , Gg          , Gg          , Gg          , Gs^Fp       , Gg          , Gg          , Gg          , Ss          , Gg          , Gg          
Hd          , Ce          , Ce          , Ds          , Ds          , Rd          , Rp          , Gg          , Ss          , Gg          , Gg          , Gg          , Wo          , Wo          , Gg          , Wo          , Wo          , Gs^Fp       , Gs^Fp       , Rd          , Gs^Fp       , Gg          , Wo          , Gg          , Wo          , Gs^Fp       , Gg          , Gs^Fp       , Gg          , Gg          , Gg          , Gs^Fp       
Dd          , Ke          , Dd          , Gs          , Gg^Vc       , Rd          , Ss          , Rp          , Rd          , Gg          , Gg          , Ggf         , Wo          , Ggf         , Gg          , Gg          , Gg          , Wo          , Ww          , Wo^Bw|      , Wo          , Wo          , Gs^Fp       , Wo          , Gg          , Wo          , Wo          , Gg          , Gg          , Gg          , Gg          , Gg          
Dd          , Dd          , Dd          , Ce          , Gs          , Gg          , Gs          , Rd          , Gg          , Rp          , Rp          , Gg          , Wo          , Gg          , Gg          , Gg          , Ggf         , Gg          , Gg          , Re          , Re          , Gs^Fp       , Gs^Fp       , Gs^Fp       , Gg          , Gg          , Gg          , Wo          , Wo          , Gs^Fp       , Wo          , Gg          
Gg          , Ss          , Ss          , Gs          , Ss          , Ds          , Gg          , Gs          , Gg          , Gs^Fp       , Rp          , Ww          , Wo          , Gg          , Gs^Fp       , Gg          , Ggf         , Gg          , Gg          , Gs^Fp       , Gg          , Re          , Re          , Gg          , Gs^Fp       , Ggf         , Gg          , Gg          , Gg          , Wo          , Ggf         , Wo          
Wo          , Ds          , Wo          , Ss          , Wo          , Gs          , Gg          , Gg          , Gg          , Gs^Fp       , Gg          , Ww^Bw\      , Gg          , Gs^Fp       , Gg          , Gg          , Gg          , Ggf         , Ggf         , Gg          , Gg          , Gg          , Rd          , Rp^Vhc      , Gg          , Gg          , Gg          , Ggf         , Ggf         , Gg          , Gg          , Gg          
Hh          , Wo          , Hh          , Wo          , Hh          , Wo          , Wo          , Wo          , Ww          , Gg          , Wo          , Ww          , Gg          , Gs^Fp       , Gg          , Gg          , Gs^Fp       , Gg          , Ggf         , Ggf         , Gg          , Gg          , Gg          , Rd          , Rd          , Gg          , Gg          , Ggf         , Gg          , Gg          , Gg^Ve       , Ggf         
Gg          , Gg          , Gg          , Hh          , Gs^Fp       , Hh          , Gg          , Gg          , Ww          , Wo          , Wo          , Wo          , Gg          , Rd          , Rd          , Rd          , Rd          , Gg          , Rd          , Rd          , Gs^Fp       , Rd          , Gg          , Gg          , Gg          , 1 Rp        , Rp          , Rp^Vhc      , Ce          , Ce          , Kv          , Gg          
Gs^Fp       , Ggf         , Ggf         , Gs^Fp       , Gs^Fp       , Gg          , Ggf         , Gg          , Wo          , Wo          , Wo          , Gg          , Gg          , Gg          , Gg          , Gg          , Gs^Fp       , Gg          , Gg          , Gg          , Ggf         , Gg          , Gg          , Gg          , Ggf         , Gg          , Rp          , Rp^Vhc      , Gg^Ve       , Cv          , Cv          , Rp^Vhc      
Gs^Fp       , Gg          , Gg          , Gg          , Gg          , Gg          , Wo          , Wo          , Ggf         , Gg          , Wo          , Ww          , Hh          , Gg          , Gg          , Gg          , Ggf         , Gg          , Gg          , Gs^Fp       , Gs^Fp       , Ggf         , Gg          , Gg          , Ggf         , Gg^Wm       , Ce          , Rp          , Rp          , Cv          , Ggf         , Rp^Vhc      
Gs^Fp       , Gs^Fp       , Gs^Fp       , Gg          , Wo          , Wo          , Gg          , Gg          , Gg          , Gg          , Gs^Fp       , Wo          , Wo          , Hh          , Gg          , Gg          , Gg          , Gg          , Gg          , Gs^Fp       , Gg          , Gg          , Ggf         , Ggf         , Gs^Fp       , Gg^Vh       , Gg^Vh       , Ce          , Rp^Vhc      , Rp          , Rp          , Gg^Wm       
