border_size=1
usage=map

Gs          , Gs          , Gs          , Gs          , Gs          , Gs          , Ds          , Ds          , Ds          , Gs          , Gs          , Gs          , Gs^Fp       , Gs^Fp       , Gs^Fp       , Gs^Fp       , Re^Gvs      , Gg          , Ggf         , Rr          , Gg          , Re          , Re^Gvs      , Re^Gvs      , Re^Gvs      , Gs^Fp       , Gs^Fp       , Gs^Fp       , Gs^Fp       , Gs^Fp       , Gg          , Gg          , Gs^Fp       , Gs^Fp       , Gs^Fp       , Rr          , Rr          , Gs          , Gs          , Gs^Fp       , Gs^Fp       , Gs^Fp       
Rd          , Rd          , Re          , Gs          , Ds          , Rd          , Rd          , Ds          , Gs^Fp       , Gs^Fp       , Gs          , Gs          , Gs          , Gs^Fp       , Re          , Re^Gvs      , Re          , Re^Gvs      , Re^Gvs      , Rr          , Gg          , Gg          , Gg          , Re          , Re^Gvs      , Re^Gvs      , Gs^Fp       , Gs^Fp       , Gs^Fp       , Gs^Fp       , Gs^Fp       , Gs^Fp       , Gs^Fp       , Gs^Fp       , Re^Gvs      , Re^Gvs      , Re^Gvs      , Rr          , Re^Gvs      , Gs^Fp       , Gs^Fp       , Gs^Fp       
Rd          , Re          , Rd          , Gs          , Ds          , Re          , Re          , Gs          , Gs^Fp       , Gs          , Ss          , Ss          , Ss          , Gs          , Rd          , Re^Gvs      , Re          , Re^Gvs      , Gs^Fp       , Rr          , Gg          , Gg          , Re          , Re^Gvs      , Re          , Gs^Fp       , Gs^Fp       , Gs^Fp       , Gs^Fp       , Gs^Fp       , Gs^Fp       , Gs^Fp       , Gs^Fp       , Wwf         , Ww          , Re          , Re^Gvs      , Rr          , Rp          , Re^Gvs      , Gs^Fp       , Gs^Fp       
Re          , Re          , Ss^Vhs      , Ss          , Ds          , Ss          , Re          , Rd          , Gs          , Gs          , Rd          , Ss          , Re          , Ss          , Rd          , Gs^Fp       , Gg          , Gg          , Gg^Vh       , Rr          , Ggf         , Re          , Re^Gvs      , Re          , Re^Gvs      , Gg          , Gg          , Gs^Fp       , Gg          , Gg^Ve       , Gs^Fp       , Gs^Fp       , Gs^Fp       , Ww          , Wo          , Ww          , Re^Gvs      , Re          , Ch          , Rp          , Wwf         , Gs          
Gs          , Rd          , Ss          , Ss          , Ss          , Ss          , Gs          , Rd          , Gs          , Gs^Vht      , Rd          , Re          , Ss          , Ss          , Rd          , Gg          , Gg          , Gg          , Gg          , Rr          , Gg          , Gs^Fp       , Gs^Fp       , Re^Gvs      , Gs^Fp       , Gg          , Gs^Fp       , Chr         , Wwf         , Gs^Fp       , Ww          , Wwf         , Ww          , Wo          , Wo          , Ww          , Ww          , Gs^Fp       , Ww          , Rp          , Ww          , Wwf         
Gs          , Gs          , Ds          , Ss          , Ss          , Ds          , Ds          , Gs^Fp       , Gs          , Ds          , Gs          , Re          , Ds          , Ss          , Rd          , Gs          , Chr         , Gg          , Re^Gvs      , Rr          , Rr          , Gs^Fp       , Gg          , Gs^Fp       , Gg          , Gg          , Gg          , Ww^Bw\      , Ww          , Ww          , Wo          , Ww          , Wo          , Wo          , Wo          , Wo          , Ww          , Ww          , Ww          , Ww^Bw|      , Ww          , Ww          
Rd          , Gs          , Ds          , Ss          , Ds          , Ss          , Ds          , Ds          , Ds          , Ds          , Gs          , Gs^Fp       , Ds          , Ss          , Gs          , Rd          , Chr         , Chr         , Re          , Re^Gvs      , Rr          , Ggf         , Re          , Gs^Fp       , Re^Gvs      , Gg          , Gs^Fp       , Wwf         , Ww          , Wo          , Wo          , Wo          , Wo          , Wo          , Wo          , Ww          , Wwf         , Wwf         , Wwf         , Ww^Bw|      , Chr         , Wwf         
Re          , Rd          , Gs^Fp       , Ds          , Ch          , Chs         , Chs         , Ds          , Ds          , Re          , Re          , Gs^Fp       , Ds          , Ds          , Gs          , Gs          , Re          , Re^Gvs      , Re          , Re          , Rr          , Re^Gvs      , Re          , Re^Gvs      , Re          , Re          , Re^Gvs      , Gs^Fp       , Wwf         , Ww          , Ww          , Ww          , Wo          , Wo          , Wo          , Ww          , Chw         , Gg          , Gs^Fp       , Rp          , Gs^Fp       , Gg          
Ds          , Rd          , Gs          , Gg^Vh       , Chr         , 4 Khs       , Chs         , Gs          , Ds          , Re          , Rd          , Rd          , Gs^Fp       , Gs          , Gs          , Re^Gvs      , Re^Gvs      , Re          , Re^Gvs      , Re          , Rr          , Re^Gvs      , Re^Gvs      , Re          , Rr          , Gs^Fp       , Gg          , Gs^Fp       , Gs^Fp       , Wwf         , Wwf         , Ww          , Ww          , Wo          , Ww          , Ww          , Gg          , Gg          , Gg          , Rp          , Gg^Ve       , Gg          
Ds          , Re          , Gs          , Gs          , Gs^Fy       , Chr         , Chs         , Ss          , Ss          , Rd          , Ds          , Ds          , Ds          , Gs          , Gs          , Gs^Fp       , Re          , Re          , Re^Gvs      , Re          , Re^Gvs      , Rr          , Rr          , Rr          , Re^Gvs      , Rr          , Rr          , Gs^Fp       , Gg          , Gg          , Wwf         , Ww          , Ww          , Ww          , Wwf         , Gg          , Gg^Vh       , Gs^Fp       , Re^Gvs      , Rp          , Gs^Fp       , Gg          
Re          , Gs          , Rd          , Rd          , Gs          , Rd          , Rd          , Gs^Fp       , Ss^Vhs      , Ss          , Ss          , Ds          , Gs          , Gs^Fp       , Gs          , Gs          , Re          , Ss          , Ss          , Gs^Fp       , Gs^Fp       , Re          , Rr          , Re^Gvs      , Re          , Re^Gvs      , Re          , Rr          , Rp          , Gg          , Ww          , Ww          , Chw         , Wwf         , Gg          , Gs^Fp       , Re^Gvs      , Re^Gvs      , Re          , Rp          , Gs^Fp       , Gs^Fp       
Gs          , Re          , Re          , Gs^Fp       , Ds          , Re          , Rd          , Gs^Fy       , Ss          , Ss          , Ds          , Ds          , Gs          , Gs^Fp       , Gs^Fp       , Gs          , Gs          , Ss          , Ss          , Ss          , Gs^Fp       , Gg          , Rr          , Re^Gvs      , Gg^Wm       , Re          , Re^Gvs      , Chr         , Ww          , Ww^Bw\      , Ww^Bw\      , Ww          , Gs^Fp       , Gg          , Re          , Re^Gvs      , Re^Gvs      , Re^Gvs      , Re          , Rp          , Gg^Wm       , Gs^Fp       
Gs          , Re          , Gs^Vht      , Ds          , Ds          , Re          , Gs          , Ds          , Ce          , Ce          , Ds          , Rd          , Gs^Fy       , Gs          , Re          , Re          , Gs          , Gs          , Ss          , Gs^Fp       , Gg          , Gg          , Rr          , Re          , Re^Gvs      , Re^Gvs      , Re^Gvs      , Wwf         , Ww          , Ww          , Gg          , Rp          , Rp          , Re^Gvs      , Re^Gvs      , Re^Gvs      , Ce          , Ce          , Ce          , Rr          , Rr          , Rp          
Ds          , Gs          , Gs^Fp       , Ss          , Ss          , Ds          , Gs          , Gs          , Rd          , 6 Ke        , Ce          , Rd          , Rd          , Rd          , Gs          , Re          , Rd          , Re          , Rr          , Gg          , Rr          , Rr          , Gg          , Rr          , Rr          , Re          , Re^Gvs      , Wwf         , Ww          , Chw         , Gg          , Gg          , Rp          , Re^Gvs      , Gg^Wm       , Re^Gvs      , Ce          , 1 Ke        , Ce          , Rr          , Gs^Fp       , Gs^Fp       
Ds          , Gs^Fp       , Gs^Fp       , Ss          , Ss          , Ds          , Gs          , Rd          , Rd          , Ce          , Gs          , Rd          , Rd          , Gs          , Re          , Ds          , Ds          , Rr          , Gs          , Rr          , Re^Gvs      , Re          , Re          , Gs^Fp       , Gg          , Rr          , Rr          , Wwf         , Ww          , Wwf         , Gs^Fp       , Gs^Fp       , Gs^Fp       , Rp          , Rp          , Re^Gvs      , Gs^Fp       , Ce          , Gg^Ve       , Rr          , Gs^Fp       , Gs^Fp       
Ss          , Ds          , Gs          , Gs          , Ss^Vhs      , Ss          , Ds          , Re          , Rd          , Gs^Fp       , Gs          , Re          , Gs          , Gs          , Ds          , Ss          , Re          , Re          , Chr         , Gg^Vh       , Re          , Re          , Re          , Re^Gvs      , Gg          , Gs^Fp       , Gs^Fp       , Rr          , Ww          , Wwf         , Gs^Fp       , Gs^Fp       , Ggf         , Gg          , Gg          , Rp          , Rp          , Gg          , Rp          , Rp          , Gs^Fp       , Gs^Fp       
Ss          , Ss          , Wwf         , Gs          , Ds          , Ss          , Ds          , Gs          , Rd          , Gs^Fp       , Gs^Fp       , Gs          , Re          , Gs          , Ss          , Ss          , Ss          , Gs          , Chr         , Chr         , Re          , Re^Gvs      , Gs^Fp       , Gs^Fp       , Gg          , Gs^Fp       , Ww          , Ww^Bw|      , Ww          , Wwf         , Gs^Fp       , Gs^Fp       , Re          , Re^Gvs      , Re^Gvs      , Gs^Fp       , Gg          , Rp          , Gg^Vh       , Gs^Fp       , Gs^Fp       , Gs^Fp       
Ss          , Wwf         , Wwf         , Ds          , Ww          , Ds          , Wwf         , Ds          , Wwf         , Ds          , Gs          , Gs          , Gs          , Ss          , Ss          , Ss^Vhs      , Ss          , Gs          , Gs          , Re          , Gs^Fp       , Gs^Fp       , Gg          , Gs^Fp       , Gs^Fp       , Wwf         , Ww          , Ww^Bw|      , Gs^Fp       , Chr         , Gg          , Re          , Re^Gvs      , Re^Gvs      , Ce          , Ce          , Ce          , Rp          , Re^Gvs      , Re^Gvs      , Re^Gvs      , Gs^Fp       
Ww          , Wwf         , Ww          , Ww          , Ss          , Ww          , Ss          , Ww          , Ww          , Wwf         , Ww^Bw|      , Wwf         , Ww          , Ds          , Ds          , Ss          , Ss          , Ss          , Ss          , Gs^Fp       , Gs^Fp       , Gg          , Gg          , Gs^Fp       , Gs^Fp       , Ww          , Ww          , Rp          , Gs^Fp       , Gs^Fp       , Ggf         , Gs^Fp       , Gs^Fp       , Gg          , Ce          , 2 Ke        , Ce          , Rp          , Re^Gvs      , Re^Gvs      , Gg          , Gg          
Ds          , Ww          , Ds          , Wwf         , Ds          , Ss          , Ss^Vhs      , Ss          , Ss          , Ww          , Ww^Bw|      , Ww          , Wo          , Ww          , Ww          , Wwf         , Wwf         , Ss          , Wwf         , Gs          , Gs          , Gg          , Gg          , Gs^Fp       , Gg          , Ww          , Ww          , Rp          , Rp          , Gg          , Ggf         , Gs^Fp       , Re^Gvs      , Gg^Vh       , Gg          , Ce          , Rp          , Rp          , Gs^Fp       , Gs^Fp       , Gg          , Ss          
Gs          , Ds          , Ds          , Rd          , Rd          , Ds          , Ss          , Ss          , Ww          , Ww          , Rd          , Ww          , Ww          , Wo          , Wo          , Ww          , Ww          , Wwf         , Ww          , Ww          , Ww          , Ww          , Ww          , Gg          , Chr         , Ww          , Ww          , Ggf         , Ggf         , Rp          , Rr          , Re^Gvs      , Re^Gvs      , Re^Gvs      , Rp          , Rp          , Gg^Ve       , Gs^Fp       , Gg          , Gs^Fp       , Ss          , Ss          
Gs          , Gs          , Gs^Vht      , Rd          , Rd          , Ds          , Ss          , Ss          , Ww          , Wwf         , Chs         , Rd          , Ds          , Ww          , Ww          , Ww          , Wwf         , Ww          , Ww          , Wo          , Wo          , Wo          , Wo          , Ww          , Wo          , Ww          , Ww          , Wwf         , Gs^Fp       , Gs^Fp       , Gs^Fp       , Rr          , Rr          , Rr          , Re^Gvs      , Re^Gvs      , Re^Gvs      , Gs^Fp       , Ss          , Gg          , Ss          , Ss          
Gs          , Gs          , Gs^Fp       , Gs          , Ww          , Ww^Bw|      , Wwf         , Ss          , Ss          , Chw         , 5 Khr       , Chr         , Ss          , Ds          , Ds          , Ds          , Ds          , Ds          , Wwf         , Ww          , Ww          , Ww          , Gg          , Ww          , Ww          , Wo          , Wo          , Ww          , Ww^Bw/      , Gs^Fp       , Gs^Fp       , Ggf         , Gg          , Rr          , Gg          , Re^Gvs      , Re^Gvs      , Re          , Gg          , Ss          , Ss          , Ss          
Wwf         , Wwf         , Ww          , Ww          , Ss          , Ss^Bw|      , Re          , Gs^Fp       , Gs^Fp       , Chs         , Chr         , Ds          , Ss          , Ss          , Ss          , Ds          , Gs          , Gg          , Rd          , Chr         , Gs^Fp       , Gs^Fp       , Re          , Gs^Fp       , Gg          , Ww          , Wo          , Ww          , Ww          , Chw         , Ggf         , Gs^Fp       , Gs^Fp       , Rr          , Gs^Fp       , Ggf         , Gs^Fp       , Gs^Fp       , Gg          , Ss          , Gg          , Gg          
Ww          , Ww          , Ww          , Ww          , Ss^Bw/      , Ss^Bw\      , Gs          , Gs          , Gs          , Rd          , Rd          , Gs          , Ss          , Ss^Vhs      , Ss          , Re          , Rd          , Rd          , Ds          , Gs          , Re          , Re          , Re^Gvs      , Re^Gvs      , Gs^Fp       , Ww          , Ww          , Wo          , Wo          , Wwf         , Gg          , Gs^Fp       , Rr          , Rr          , Ggf         , Gg          , Gs^Fp       , Gs^Fp       , Gg          , Gg          , Gs^Fp       , Gg          
Gs^Fp       , Gs^Fp       , Ds          , Ss^Bw/      , Ss          , Ss          , Ss          , Re          , Ce          , Re          , Rd          , Gs^Fy       , Rd          , Rd          , Rd          , Re          , Rd          , Ds          , Ds          , Ds          , Gs^Vht      , Re          , Gs^Fp       , Gs^Fp       , Gs^Fp       , Gs^Fp       , Ww          , Wo          , Wo          , Ww          , Gg          , Rr          , Gg^Ve       , Rr          , Rr          , Ggf         , Re^Gvs      , Gg          , Gs^Fp       , Gs^Fp       , Gs^Fp       , Gg          
Gs^Fp       , Gs^Fp       , Ds          , Ss          , Ss          , Ss^Vhs      , Ss          , Ds          , Gs          , Ce          , 3 Ke        , Re          , Re          , Rd          , Re          , Gs^Fp       , Gs^Fp       , Rd          , Ds          , Gs^Fp       , Gs          , Gs          , Chr         , Gs^Fp       , Gg^Vh       , Gs^Fp       , Ww          , Wo          , Wo          , Ww          , Chr         , Rr          , Ggf         , Gs^Fp       , Rp          , Re^Gvs      , Re          , Re^Gvs      , Re^Gvs      , Gs^Fp       , Gg          , Gg          
Gs          , Gs          , Gs          , Ds          , Re          , Gs          , Rd          , Ds          , Rd          , Rd          , Re          , Ce          , Ce          , Re          , Rd          , Rd          , Gs^Fp       , Rd          , Re          , Gs          , Gg          , Gs^Fp       , Chr         , Gs^Fp       , Gg          , Gg          , Ch          , Ww          , Wo          , Ww          , Rr          , Rr          , Gs^Fp       , Gs^Fp       , Gs^Fp       , Rp          , Rp          , Re^Gvs      , Gg^Vh       , Gg          , Rp          , Rp          
Gs          , Gs          , Gs^Fp       , Re          , Gs^Fp       , Rd          , Gs^Vht      , Re          , Gs          , Re          , Ds          , Gs^Fp       , Gs^Fp       , Rd          , Ds          , Ds          , Re          , Rd          , Rd          , Re          , Gs^Fp       , Gs^Fp       , Gs^Fp       , Gs^Fp       , Re^Gvs      , Gs^Fp       , Gg          , Ww          , Wo^Bw/      , Wo^Bw/      , Ww          , Gg          , Gg          , Ggf         , Gs^Fp       , Gs^Fp       , Gs^Fp       , Rp          , Rp          , Rp          , Gg          , Gg          
Rd          , Rd          , Re          , Gs^Fp       , Gs          , Gs          , Gs          , Rd          , Gs^Fp       , Re          , Re          , Gs^Fp       , Gs^Fp       , Gs^Vht      , Ss          , Ds          , Ss          , Re          , Rd          , Re          , Gs^Fp       , Gg          , Re          , Re          , Re^Gvs      , Re^Gvs      , Rr          , Ww^Bw/      , Ww          , Wo          , Wo          , Ww          , Ww          , Chr         , Gg          , Gs^Fp       , Gs^Fp       , Gg          , Rp          , Gg          , Gs^Fp       , Gs^Fp       
Re          , Rd          , Re          , Rd          , Gs          , Gs          , Rd          , Gs          , Re          , Gs^Fp       , Ss          , Ss          , Ss          , Ss          , Ss          , Ss          , Gs          , Ds          , Gs^Fp       , Rd          , Gs          , Gg^Wm       , Gg          , Re^Gvs      , Rr          , Rr          , Re          , Re^Gvs      , Re          , Ww          , Ww          , Wo          , Wo          , Ww          , Gs^Fp       , Gs^Fp       , Gs^Fp       , Ggf         , Rp          , Gs^Fp       , Gs^Fp       , Gs^Fp       
Gs          , Gs          , Re          , Gs          , Gs          , Gs          , Rd          , Re          , Re          , Re          , Gs          , Ss          , Ss          , Ss          , Ss          , Gs          , Gs          , Gs          , Gs          , Gs          , Gs          , Gg          , Rr          , Rr          , Gs^Fp       , Re^Gvs      , Re^Gvs      , Re          , Gs^Fp       , Gg          , Ww          , Wo          , Wo          , Ww          , Gg          , Ggf         , Gg          , Gs^Fp       , Rp          , Gg          , Gs^Fp       , Gs^Fp       
