border_size=1
usage=map

Gs^Fp       , Gs^Fp       , Re^Gvs      , Re          , Re^Gvs      , Re^Gvs      , Re^Gvs      , Re          , Re^Gvs      , Re^Gvs      , Re          , Re          , Re^Gvs      , Gs^Fp       , Gs^Fp       , Gs^Fp       , Gs^Fp       , Gs^Fp       , Re^Gvs      , Re^Gvs      , Re^Gvs      , Re^Gvs      , Re          , Re          , Re          , Re^Gvs      , Re^Gvs      , Re^Gvs      , Re^Gvs      , Re^Gvs      , Gs^Fp       , Gs^Fp       , Re^Gvs      , Re^Gvs      , Re^Gvs      , Re^Gvs      , Gs^Fp       , Gs^Fp       , Gs^Fp       , Re^Gvs      , Re          , Re^Gvs      
Gs^Fp       , Gs^Fp       , Gs^Fp       , Re^Gvs      , Gg^Vh       , Re^Gvs      , Re^Gvs      , Re^Gvs      , Re^Gvs      , Re          , Re          , Re^Gvs      , Re^Gvs      , Re^Gvs      , Re^Gvs      , Re^Gvs      , Re          , Re          , Re          , Re^Gvs      , Gg^Vh       , Re^Gvs      , Re^Gvs      , Re          , Re^Gvs      , Re^Gvs      , Gg^Ve       , Re^Gvs      , Re^Gvs      , Re^Gvs      , Gs^Fp       , Gs^Fp       , Re^Gvs      , Re          , Re          , Gs^Fp       , Gs^Fp       , Re^Gvs      , Re^Gvs      , Re^Gvs      , Re^Gvs      , Re^Gvs      
Gs^Fp       , Gs^Fp       , Re^Uf       , Re^Uf       , Gs^Fp       , Gs^Fp       , Re^Gvs      , Re          , Re          , Ce          , Ce          , Re^Gvs      , Re^Gvs      , Re          , Re^Gvs      , Re^Gvs      , Re^Gvs      , Re          , Re^Gvs      , Re          , Gs^Fp       , Gs^Fp       , Re^Gvs      , Re^Gvs      , Re^Gvs      , Re^Gvs      , Re^Gvs      , Re^Gvs      , Re^Gvs      , Gs^Fp       , Gs^Fp       , Re^Gvs      , Re^Gvs      , Re          , Re^Gvs      , Re^Gvs      , Gs^Fp       , Gg^Ve       , Re          , Re          , Re^Gvs      , Re^Gvs      
Gg          , Gg          , Gg          , Re^Uf       , Gs^Fp       , Gs^Fp       , Ggf         , Re^Gvs      , Re^Gvs      , Ce          , 3 Ke        , Ce          , Ce          , Re^Gvs      , Re          , Re          , Re^Gvs      , Re^Gvs      , Re^Gvs      , Re^Gvs      , Re^Gvs      , Gs^Fp       , Re^Gvs      , Re          , Re^Gvs      , Re^Gvs      , Ce          , Re^Gvs      , Re^Gvs      , Re^Gvs      , Re^Gvs      , Ggf         , Gg^Vwm      , Re^Gvs      , Re^Gvs      , Re^Gvs      , Gs^Fp       , Re^Gvs      , Re^Gvs      , Re^Gvs      , Gs^Fp       , Gs^Fp       
Gs^Fp       , Gg          , Gg          , Re^Uf       , Gs^Fp       , Gs^Fp       , Gs^Fp       , Re          , Re^Gvs      , Ce          , Ce          , Ce          , Re          , Re^Gvs      , Gs^Fp       , Re^Gvs      , Re^Gvs      , Re^Gvs      , Gg          , Re          , Re^Gvs      , Re^Gvs      , Gg          , Re^Gvs      , Re^Gvs      , Ce          , 1 Ke        , Ce          , Re^Gvs      , Re          , Re^Gvs      , Gg          , Re^Gvs      , Re^Gvs      , Re          , Re^Gvs      , Re^Gvs      , Gs^Fp       , Gs^Fp       , Gg          , Ggf         , Gs^Fp       
Gs^Fp       , Gg          , Gg          , Gg          , Gs^Fp       , Gs^Fp       , Gs^Fp       , Gs^Fp       , Gg          , Re^Gvs      , Re          , Re^Gvs      , Gs^Fp       , Gs^Fp       , Gs^Fp       , Re^Gvs      , Re^Gvs      , Ggf         , Re^Gvs      , Re          , Re^Gvs      , Re^Gvs      , Gs^Fp       , Gg          , Gg          , Ce          , Ce          , Ce          , Re^Gvs      , Re          , Re^Gvs      , Re^Gvs      , Re^Gvs      , Re          , Re^Gvs      , Re^Gvs      , Gg          , Gs^Fp       , Gs^Fp       , Gs^Fp       , Gs^Fp       , Gs^Fp       
Gg          , Gg          , Re          , Re^Gvs      , Re^Gvs      , Gg^Ve       , Gs^Fp       , Ggf         , Gg          , Gg          , Gg          , Ggf         , Gg^Vh       , Gs^Fp       , Gs^Fp       , Re^Gvs      , Gs^Fp       , Gs^Fp       , Re^Gvs      , Re^Gvs      , Re          , Gs^Fp       , Gs^Fp       , Gg          , Gg          , Gg          , Gg          , Gg^Ve       , Re^Gvs      , Re^Gvs      , Re^Gvs      , Gs^Fp       , Gg^Vh       , Re^Gvs      , Re^Gvs      , Gg          , Gg          , Gs^Fp       , Gg          , Gs^Fp       , Gs^Fp       , Gs^Fp       
Gg          , Re^Gvs      , Re          , Re          , Re^Gvs      , Re^Gvs      , Re^Gvs      , Gg          , Gg          , Gg          , Re^Gvs      , Re^Gvs      , Re^Gvs      , Gs^Fp       , Gs^Fp       , Gs^Fp       , Re^Gvs      , Re^Gvs      , Re          , Re          , Re^Gvs      , Re^Gvs      , Gs^Fp       , Gs^Fp       , Re          , Ggf         , Gg          , Re          , Re^Gvs      , Re^Gvs      , Gs^Fp       , Gs^Fp       , Re^Gvs      , Re^Gvs      , Re          , Re^Gvs      , Ce          , Ggf         , Re^Gvs      , Re^Gvs      , Re^Gvs      , Gg          
Gs^Fp       , Gg          , Gg          , Re^Gvs      , Re^Gvs      , Re^Gvs      , Gg          , Gg          , Gs^Fp       , Re^Gvs      , Re^Gvs      , Re          , Re^Gvs      , Re^Gvs      , Re          , Gs^Fp       , Gs^Fp       , Re          , Re^Gvs      , Re^Gvs      , Gg          , Gg          , Re^Gvs      , Re^Gvs      , Re^Gvs      , Re          , Re          , Gs^Fp       , Gs^Fp       , Gs^Fp       , Gs^Fp       , Gs^Fp       , Gs^Fp       , Re^Gvs      , Re^Gvs      , Re^Gvs      , Ce          , Ce          , Ce          , Re^Gvs      , Re^Gvs      , Re^Gvs      
Gs^Fp       , Gs^Fp       , Gs^Fp       , Gg          , Gg          , Gg          , Gg          , Gg          , Re^Gvs      , Gs^Fp       , Gs^Fp       , Re          , Re          , Re^Gvs      , Re          , Re^Gvs      , Gg          , Ggf         , Hh          , Gg^Vh       , Gg          , Gg          , Gg          , Re^Gvs      , Re          , Re          , Gs^Fp       , Gs^Fp       , Re          , Gs^Fp       , Re^Gvs      , Gg          , Re          , Gs^Fp       , Gs^Fp       , Re^Gvs      , Ce          , 2 Ke        , Ce          , Re          , Re^Gvs      , Hh          
Gs^Fp       , Gs^Fp       , Gs^Fp       , Gg^Vh       , Gs^Fp       , Gg          , Re^Gvs      , Re^Gvs      , Re          , Re^Gvs      , Re^Gvs      , Gg          , Gg          , Re^Gvs      , Gg^Ve       , Gs^Fp       , Gg          , Gg          , Gs^Fp       , Hh          , Hh          , Ggf         , Hh          , Ggf         , Hh          , Gg^Ve       , Re          , Re^Gvs      , Re^Gvs      , Re^Gvs      , Re          , Re^Gvs      , Re^Gvs      , Re^Gvs      , Re^Gvs      , Gg^Vwm      , Re^Gvs      , Ce          , Ce          , Re          , Re^Gvs      , Hh          
Gg          , Gs^Fp       , Re^Uf       , Gs^Fp       , Gs^Fp       , Hh          , Hh          , Re^Gvs      , Re^Gvs      , Re          , Re^Gvs      , Re^Gvs      , Re^Gvs      , Hh          , Gs^Fp       , Gg          , Gg          , Ggf         , Gs^Fp       , Gs^Fp       , Gs^Fp       , Hh          , Mm          , Hh          , Hh          , Re          , Re^Gvs      , Re^Gvs      , Hh          , Re          , Hh          , Re^Gvs      , Re^Gvs      , Re          , Re^Gvs      , Re^Gvs      , Re^Gvs      , Re^Gvs      , Re^Gvs      , Re^Gvs      , Chr         , Hh          
Hh          , Re^Uf       , Re^Uf       , Re^Uf       , Hh          , Hh          , Re^Gvs      , Re^Gvs      , Re^Gvs      , Re          , Re^Gvs      , Re^Gvs      , Gs^Fp       , Gs^Fp       , Gs^Fp       , Hh          , Gs^Fp       , Ss          , Ss          , Ss          , Gs^Fp       , Mm          , Mm          , Hh          , Mm          , Mm          , Hh          , Hh          , Hh          , Hh          , Hh          , Gs^Fp       , Gs^Fp       , Re^Uf       , Re^Uf       , Re^Gvs      , Hh          , Hh          , Hh          , Ggf         , Ww          , Ww          
Hh          , Hh          , Gg          , Hh          , Re^Gvs      , Re^Gvs      , Re          , Re^Gvs      , Re^Gvs      , Re^Gvs      , Hh          , Ggf         , Re^Gvs      , Gs^Fp       , Hh          , Hh          , Gs^Fp       , Ss          , Ss          , Gs^Fp       , Hh          , Mm          , Mm          , Hh          , Mm          , Mm          , Mm          , Mm          , Mm          , Mm          , Mm          , Gs^Fp       , Chr         , Re^Uf       , Ww          , Hh          , Wwf         , Hh          , Ww          , Wwf         , Ww          , Ww          
Mm          , Hh          , Hh          , Re^Gvs      , Re^Gvs      , Re^Gvs      , Re^Gvs      , Re^Gvs      , Gs^Fp       , Gs^Fp       , Re^Gvs      , Re^Gvs      , Re          , Re^Gvs      , Re^Gvs      , Hh          , Gs^Fp       , Gs^Fp       , Ss          , Gs^Fp       , Hh          , Hh          , Mm          , Mm          , Mm          , Mm          , Hh          , Mm          , Mm          , Mm          , Hh          , Hh          , Wwf         , Ww          , Ww          , Ww          , Wwf         , Ww          , Ww          , Wwf         , Gg          , Ww          
Mm          , Mm          , Mm          , Hh          , Gg          , Re^Gvs      , Ggf         , Gg          , Re^Gvs      , Re^Gvs      , Re          , Re^Gvs      , Re          , Re          , Hh          , Ggf         , Hh          , Re^Uf       , Hh          , Hh          , Hh          , Hh          , Mm          , Mm          , Hh          , Chr         , Hh          , Hh          , Hh          , Hh          , Ww          , Hh          , Ww          , Wwf         , Wwf         , Wwf         , Wwf         , Ww          , Wwf         , Wwf         , Wwf         , Gg          
Mm          , Mm          , Hh          , Hh          , Mm          , Gg          , Gg          , Hh          , Hh          , Re^Gvs      , Re^Gvs      , Re          , Ggf         , Gg          , Gg          , Hh          , Re^Uf       , Re^Uf       , Re^Uf       , Hh          , Mm          , Mm          , Hh          , Hh          , Ww          , Ww          , Ww          , Wwf         , Ww          , Ww          , Ww          , Ww          , Wwf         , Ww          , Wwf         , Wwf         , Wwf         , Ww          , Gs^Fp       , Wwf         , Wwf         , Ww          
Hh          , Hh          , Hh          , Hh          , Mm          , Hh          , Mm          , Hh          , Hh          , Hh          , Gs^Fp       , Hh          , Hh          , Hh          , Gg          , Gg          , Hh          , Re^Uf       , Mm          , Mm          , Mm          , Mm          , Ww          , Hh          , Ww          , Ww          , Ww          , Wwf         , Wwf         , Ww          , Ww          , Wwf         , Wwf         , Wwf         , Wwf         , Wwf         , Ggf         , Ggf         , Gs^Fp       , Gg          , Gg          , Gg          
Hh          , Hh          , Mm          , Mm          , Mm          , Mm          , Mm          , Hh          , Hh          , Gg^Ve       , Gs^Fp       , Gs^Fp       , Ggf         , Gs^Fp       , Gs^Fp       , Gs^Fp       , Hh          , Hh          , Mm          , Mm          , Mm          , Wwf         , Ww          , Wwf         , Wwf         , Ww          , Ww          , Wwf         , Wwf         , Ww          , Ggf         , Wwf         , Gg          , Gg          , Hh          , Gg          , Ggf         , Ggf         , Gs^Fp       , Gs^Fp       , Gg          , Gg          
Hh          , Hh          , Mm          , Mm          , Mm          , Mm          , Mm          , Hh          , Hh          , Hh          , Hh          , Gg          , Gs          , Gs          , Gg^Ve       , Gs^Fp       , Hh          , Hh          , Mm          , Mm          , Mm          , Wwf         , Wwf         , Ww          , Wwf         , Ww          , Ww          , Ww          , Ce          , Gg          , Ggf         , Ggf         , Ggf         , Gg          , Gs          , Hh          , Gg          , Ggf         , Gs          , Gs^Fp       , Gg          , Gg          
Hh          , Hh          , Mm          , Mm          , Chr         , Mm          , Mm          , Mm          , Mm          , Hh          , Gs^Fp       , Gs^Fp       , Gs          , Gs^Fp       , Gs^Fp       , Gg          , Hh          , Hh          , Chr         , Mm          , Wwf         , Ww          , Wwf         , Wwf         , Wwf         , Wwf         , Gs^Fp       , Ce          , 5 Ke        , Ce          , Hh          , Gs^Fp       , Gs^Fp       , Gs^Fp       , Hh          , Gs          , Gg          , Ggf         , Gs^Fp       , Gs^Fp       , Gs          , Gg          
Mm          , Mm          , Mm          , Mm          , Hh          , Hh          , Mm          , Mm          , Mm          , Chr         , Gs^Fp       , Gs^Fp       , Gs^Fp       , Ggf         , Gs^Fp       , Hh          , Wwf         , Mm          , Ww          , Wwf         , Wwf         , Ww          , Ww          , Wwf         , Gg          , Gs^Fp       , Gs^Fp       , Ce          , Ce          , Hh          , Gs^Fp       , Gs^Fp       , Re^Uf       , Gs^Vht      , Hh          , Hh          , Hh          , Hh          , Gs          , Gs          , Gs^Fp       , Gg          
Mm          , Mm          , Hh          , Hh          , Ww          , Hh          , Ww          , Mm          , Ww          , Mm          , Wwf         , Gs^Fp       , Wwf         , Ww          , Ww          , Ww          , Wwf         , Ww          , Ww          , Ww          , Wwf         , Ww          , Ss          , Ss          , Ss          , Gs^Fp       , Gg^Vh       , Gs^Fp       , Gs^Fp       , Gs^Fp       , Gs^Fp       , Gs^Fp       , Re^Uf       , Re^Uf       , Hh          , Hh          , Hh          , Gs          , Gs          , Gs^Fp       , Gs^Fp       , Gs^Fp       
Hh          , Hh          , Ww          , Wwf         , Wwf         , Wwf         , Wwf         , Ww          , Ww          , Ww          , Wwf         , Wwf         , Wwf         , Wwf         , Ww          , Ww          , Wwf         , Ww          , Wwf         , Ww          , Wwf         , Ss          , Ss          , Ss          , Ww          , Ss          , Ww          , Ss          , Ss          , Ss          , Ss          , Gg          , Hh          , Hh          , Gg          , Hh          , Gg          , Gg          , Gs          , Gs^Fp       , Gs          , Gg          
Ww          , Ww          , Ww          , Ww          , Gs^Fp       , Wwf         , Wwf         , Ww          , Wwf         , Ww          , Gs^Fp       , Wwf         , Gs^Fp       , Wwf         , Gs^Fp       , Wwf         , Ww          , Wwf         , Ww          , Wwf         , Wwf         , Ss          , Gg          , Ss          , Ggf         , Ww          , Gg          , Ww          , Ww          , Ww          , Ww          , Ww          , Ww          , Hh          , Ss          , Gg          , Gg          , Gs^Fp       , Gs^Fp       , Gs^Fp       , Ggf         , Gg          
Ss          , Ww          , Wwf         , Wwf         , Gs^Fp       , Gs^Fp       , Wwf         , Wwf         , Wwf         , Gs^Fp       , Gs^Fp       , Gs^Fp       , Gg^Vh       , Gs^Fp       , Wwf         , Wwf         , Wwf         , Ww          , Ww          , Ww          , Wwf         , Wwf         , Gg          , Ggf         , Ggf         , Gs^Fp       , Gs^Fp       , Gs^Fp       , Gs          , Hh          , Hh          , Ss          , Ss          , Ss          , Ss          , Ss          , Ss          , Ss          , Ss          , Ss          , Ss          , Gg          
Ss          , Gs^Fp       , Ww          , Wwf         , Wwf         , Wwf         , Ww          , Gs^Fp       , Ww          , Wwf         , Ww          , Ww          , Wwf         , Wwf         , Ww          , Wwf         , Wwf         , Ww          , Gs^Fp       , Ss          , Ww          , Wwf         , Wwf         , Gg          , Gg          , Gs^Fp       , Gs^Fp       , Ggf         , Gs          , Hh          , Hh          , Gs^Fp       , Ss          , Hh^Vhh      , Ss          , Hh          , Gg          , Ss          , Ss          , Ss          , Ss          , Ss          
Ww          , Ww          , Ww          , Ww          , Wwf         , Ww          , Ww          , Ww          , Ww          , Wwf         , Ww          , Ww          , Wwf         , Wwf         , Ww          , Wwf         , Wwf         , Gg          , Gs^Fp       , Ggf         , Ww          , Wwf         , Hh          , Wwf         , Ss          , Ggf         , Ss          , Ggf         , Gs^Fp       , Gs          , Hh          , Gs^Fp       , Re^Uf       , Re^Uf       , Hh          , Hh          , Ggf         , Gg          , Gg          , Gg^Vh       , Gg          , Ss          
Ss          , Ww          , Ss          , Wwf         , Wwf         , Ww          , Ggf         , Ww          , Ce          , Wwf         , Gg          , Wwf         , Ss          , Gg          , Ww          , Wwf         , Gg          , Ss          , Ss          , Ss          , Ss          , Ww          , Ww          , Wwf         , Ss          , Ss          , Hh          , Gs          , Gs          , Gs^Fp       , Gs^Fp       , Re^Uf       , Re^Uf       , Re^Uf       , Hh          , Gs          , Ce          , Ce          , Ce          , Gs^Fp       , Gs^Fp       , Gg          
Gg          , Ss          , Ss          , Ww          , Wwf         , Gs^Fp       , Gs^Fp       , Ce          , 4 Ke        , Ce          , Ggf         , Gs^Fp       , Ss          , Gg          , Ww          , Wwf         , Gg          , Gs^Fp       , Gs^Fp       , Gg          , Ss          , Ss          , Hh          , Ww          , Hh          , Hh          , Hh^Vhh      , Hh          , Hh          , Gs^Fp       , Gg          , Gs^Fp       , Gg          , Gs^Fp       , Ggf         , Gs          , Ce          , 6 Ke        , Gs          , Gs^Fp       , Ss          , Gg          
Gs^Fp       , Ggf         , Ss          , Gg          , Ww          , Ggf         , Gs^Fp       , Ce          , Ce          , Ce          , Gs^Fp       , Ss          , Gg          , Wwf         , Ss          , Ss          , Ggf         , Gs^Fp       , Gg^Vh       , Gg          , Hh          , Ss          , Wwf         , Wwf         , Gg          , Hh          , Hh          , Hh          , Hh          , Gg          , Hh          , Ggf         , Gs^Fp       , Gs^Fp       , Ss          , Ggf         , Gs^Fp       , Ce          , Hh          , Ss          , Ss          , Gg          
Gs^Fp       , Gs^Fp       , Gg^Vh       , Ss          , Re^Uf       , Wwf         , Ww          , Ss          , Ss          , Gg^Vh       , Gg          , Gs^Fp       , Wwf         , Wwf         , Ss          , Ss          , Gs^Fp       , Gg          , Gg          , Hh          , Hh          , Ss          , Gs^Fp       , Wwf         , Wwf         , Gg          , Hh          , Gg          , Gs^Fp       , Hh          , Ss          , Gg          , Gs^Fp       , Gs^Fp       , Gs^Fp       , Ss          , Gs^Vht      , Ggf         , Hh          , Ss          , Ss          , Gs^Fp       
Gs^Fp       , Gs^Fp       , Re^Uf       , Re^Uf       , Re^Uf       , Wwf         , Wwf         , Ss          , Gg          , Ggf         , Gs^Fp       , Gg          , Wwf         , Wwf         , Gg          , Ggf         , Gs^Fp       , Gs^Fp       , Re^Uf       , Ggf         , Re^Uf       , Gs^Fp       , Gs^Fp       , Re^Uf       , Wwf         , Wwf         , Ww          , Gs^Fp       , Gs^Fp       , Ss          , Ss          , Hh          , Ss          , Ss          , Gs^Fp       , Ss          , Gs^Fp       , Ggf         , Re^Uf       , Hh          , Gs^Fp       , Gs^Fp       
Re^Uf       , Ss          , Ss          , Re^Uf       , Wwf         , Wwf         , Wwf         , Wwf         , Ggf         , Gs^Fp       , Wwf         , Wwf         , Ww          , Gg          , Re^Uf       , Gs^Fp       , Gs^Fp       , Gs^Fp       , Re^Uf       , Re          , Re          , Rd          , Ss          , Re          , Ss          , Wwf         , Ww          , Gg          , Gg          , Ss          , Re^Uf       , Gs^Fp       , Gs^Fp       , Ss          , Ss          , Gs^Fp       , Re^Uf       , Gs^Fp       , Re^Uf       , Re^Uf       , Gs          , Gs          
Re^Uf       , Ss          , Ss          , Wwf         , Re^Uf       , Re^Uf       , Ss          , Ss          , Re^Uf       , Gs^Fp       , Wwf         , Wwf         , Ww          , Ss          , Ss          , Re^Uf       , Gs^Fp       , Re^Uf       , Ss          , Ss          , Ss          , Rd          , Ss          , Ss          , Ss          , Wwf         , Ww          , Hh          , Hh          , Hh          , Hh          , Re^Uf       , Gs^Fp       , Re^Uf       , Hh          , Hh          , Mm          , Gs^Fp       , Gs^Fp       , Gs^Fp       , Re^Uf       , Gg          
Ss          , Re^Uf       , Re^Uf       , Wwf         , Hh          , Ss          , Ss          , Re^Uf       , Re^Uf       , Ss          , Ww          , Wwf         , Hh          , Ss          , Mm          , Re^Uf       , Ch          , Ch          , Ch          , Ss          , Hh^Vhh      , Re          , Re^Uf       , Ss          , Ss          , Hh          , Wwf         , Ww          , Mm          , Mm^Xm       , Mm          , Hh          , Gs^Fp       , Hh          , Ss          , Hh          , Re^Uf       , Re^Uf       , Re          , Re^Uf       , Re          , Gg          
Gg          , Hh          , Wwf         , Wwf         , Hh          , Ww          , Hh          , Re^Uf       , Mm^Vhh      , Ww          , Ss          , Wwf         , Wwf         , Mm          , Mm          , Gs^Fp       , Hh          , 7 Kh        , Ch          , Hh          , Hh          , Hh          , Re^Uf       , Rd          , Re^Uf       , Re          , Wwf         , Ww          , Mm^Xm       , Mm          , Hh          , Ss          , Ss          , Ss          , Ss          , Mm          , Re          , Re          , Re^Uf       , Re^Uf       , Rd          , Re          
Hh          , Hh          , Wwf         , Mm          , Ww          , Ww          , Hh          , Mm          , Mm          , Ww          , Ss          , Hh          , Mm          , Mm^Xm       , Mm          , Hh          , Mm          , Ch          , Hh          , Ww          , Wwf         , Wwf         , Wwf         , Wwf         , Wwf         , Wwf         , Ww          , Ww          , Ss          , Mm^Xm       , Hh          , Ss          , Ww          , Gs^Fp       , Re^Uf       , Rd          , Re^Uf       , Rd          , Rd          , Re^Uf       , Rd          , Rd          
Hh          , Ww          , Mm          , Ww          , Wwf         , Hh          , Mm          , Mm          , Mm          , Ww          , Hh          , Hh          , Mm          , Mm          , Mm          , Mm^Vhh      , Ss          , Ss          , Re^Uf       , Ww          , Ww          , Ww          , Hh          , Ss          , Ss          , Wwf         , Ww          , Ss          , Mm          , Mm^Xm       , Mm^Xm       , Ww          , Ww          , Ss          , Ss          , Ss          , Re          , Rd          , Re^Uf       , Re^Uf       , Rd          , Re^Uf       
Ww          , Wwf         , Mm          , Mm          , Wwf         , Hh          , Mm          , Mm          , Mm          , Ww          , Ww          , Mm          , Mm^Xm       , Mm          , Mm          , Mm          , Ss          , Ss          , Rd          , Re^Uf       , Rd          , Rd          , Hh^Vhh      , Hh          , Hh          , Ww          , Hh          , Ss          , Mm          , Mm          , Mm^Xm       , Mm          , Mm          , Ww          , Ss          , Re^Uf       , Mm          , Re^Uf       , Re^Uf       , Re          , Hh^Vhh      , Hh          
Mm          , Mm          , Mm          , Mm          , Mm          , Mm          , Mm          , Mm          , Mm          , Mm          , Ww          , Mm          , Mm          , Mm          , Mm          , Hh          , Mm          , Mm          , Mm          , Re^Uf       , Mm          , Mm          , Mm          , Hh          , Mm          , Ww          , Mm          , Mm          , Mm          , Mm          , Mm          , Mm          , Mm          , Ss          , Mm          , Mm          , Mm^Xm       , Re          , Re^Uf       , Hh          , Hh          , Hh          
Mm          , Mm          , Mm          , Wwf         , Mm          , Mm          , Mm          , Mm          , Mm          , Mm          , Mm          , Ww          , Mm          , Mm          , Mm          , Mm          , Mm          , Mm          , Mm          , Mm          , Mm          , Mm          , Mm          , Mm          , Mm          , Ww          , Mm          , Mm          , Mm          , Mm          , Hh          , Hh          , Hh          , Hh          , Hh          , Mm^Xm       , Hh          , Hh          , Hh          , Hh          , Hh          , Hh          
