border_size=1
usage=map

Mm          , Mm          , Mm          , Mm          , Mm          , Mm          , Mm          , Mm          , Mm          , Mm          , Aa          , Aa          , Aa          , Mm          , Mm          , Mm          , Mm          , Mm          , Mm          , Mm          , Mm          , Mm          , Mm^Xm       , Mm^Xm       , Mm^Xm       , Mm^Xm       
Mm          , Mm          , Mm          , Mm          , Mm          , Mm          , Mm          , Mm          , Hh          , Gs^Fp       , Ce          , Aa^Fpa      , 1 Ke        , Aa          , Ce          , Hh          , Hh          , Mm          , Mm          , Mm          , Mm          , Mm          , Mm^Xm       , Mm^Xm       , Mm^Xm       , Mm^Xm       
Mm          , Mm          , Mm          , Mm          , Mm          , Mm          , Mm          , Mm          , Mm          , Hh          , Gs^Fp       , Ce          , Gs          , Ce          , Gs^Fp       , Gs^Fp       , Gs^Fp       , Hh          , Mm          , Mm          , Mm          , Mm          , Mm^Xm       , Mm^Xm       , Mm^Xm       , Mm^Xm       
Mm          , Mm          , Mm          , Mm          , Mm          , Mm          , Mm          , Mm          , Mm          , Hh          , Hh          , Gs^Fp       , Gs          , Gs          , Gs^Fp       , Gs^Fp       , Hh          , Hh          , Mm          , Mm          , Mm          , Mm          , Mm^Xm       , Mm^Xm       , Mm^Xm       , Mm^Xm       
Mm          , Mm          , Mm          , Mm          , Mm          , Mm          , Mm          , Mm          , Ha          , Hh          , Gs^Fp       , Gs^Fp       , Gs^Fp       , Aa^Fpa      , Aa^Fpa      , Gs^Fp       , Hh          , Mm          , Mm          , Mm          , Mm          , Mm          , Mm^Xm       , Mm^Xm       , Mm^Xm       , Mm^Xm       
Mm          , Mm          , Mm          , Mm          , Mm          , Mm          , Mm          , Mm          , Ha          , Ha          , Aa^Fpa      , Aa^Fpa      , Gs^Fp       , Aa^Fpa      , Gs^Fp       , Gs^Fp       , Aa^Fpa      , Hh          , Mm          , Mm          , Mm          , Mm          , Mm^Xm       , Mm^Xm       , Mm^Xm       , Mm^Xm       
Mm          , Mm          , Mm          , Mm          , Mm          , Mm          , Mm          , Mm          , Ha          , Ha^Vhha     , Gs^Fp       , Aa^Fpa      , Aa^Fpa      , Aa^Fpa      , Aa^Fpa      , Gs^Fp       , Aa^Fpa      , Ha          , Mm          , Mm          , Mm          , Mm          , Mm^Xm       , Mm^Xm       , Mm^Xm       , Mm^Xm       
Mm          , Mm          , Mm          , Mm          , Mm          , Mm          , Mm          , Ha          , Ha          , Gs^Fp       , Gs^Fp       , Gs^Fp       , Aa^Fpa      , Aa^Fpa      , Aa^Fpa      , Ha          , Aa^Fpa      , Ha          , Mm          , Mm          , Mm          , Mm          , Mm^Xm       , Mm^Xm       , Mm^Xm       , Mm^Xm       
Mm          , Mm          , Mm          , Mm^Vhh      , Mm          , Ha          , Ha          , Hh          , Hh          , Aa          , Aa^Fpa      , Gs^Fp       , Aa          , Aa^Fpa      , Aa^Fpa      , Ha          , Ha          , Ha          , Mm          , Mm          , Mm          , Mm          , Mm^Xm       , Mm^Xm       , Mm^Xm       , Mm^Xm       
Mm          , Mm          , Mm          , Mm          , Ha          , Ha          , Mm          , Hh          , Hh          , Gs^Fp       , Aa^Fpa      , Aa^Fpa      , Gs^Fp       , Gs^Fp       , Aa^Fpa      , Aa^Vha      , Hh          , Mm          , Mm          , Mm          , Mm          , Mm          , Mm^Xm       , Mm^Xm       , Mm^Xm       , Mm^Xm       
Mm          , Mm          , Ha          , Mm          , Ai          , Ha          , Mm          , Mm          , Ha          , Aa^Fpa      , Gs^Fp       , Gs          , Aa          , Gs^Fp       , Gs^Fp       , Ha          , Hh          , Mm          , Mm^Xm       , Mm          , Mm          , Mm          , Mm^Xm       , Mm^Xm       , Mm^Xm       , Mm^Xm       
Ai          , Ai          , Ai          , Ai          , Ai          , Ai          , Ai          , Ai          , Aa^Fpa      , Hh          , Hh          , Hh          , Aa^Fpa      , Gs^Fp       , Gs^Fp       , Aa^Fpa      , Ha          , Mm          , Mm          , Mm          , Mm          , Mm          , Mm^Xm       , Mm^Xm       , Mm^Xm       , Mm^Xm       
Ai          , Ai          , Mm^Xm       , Ai          , Mm          , Mm          , Mm          , Gs^Fp       , Gs^Fp       , Ha          , Ha          , Aa^Fpa      , Aa          , Aa^Fpa      , Gs^Fp       , Aa          , Ha          , Mm          , Mm          , Mm          , Mm          , Mm          , Mm^Xm       , Mm^Xm       , Mm^Xm       , Mm^Xm       
Mm          , Mm          , Mm          , Mm          , Mm          , Mm          , Mm          , Gs^Fp       , Aa^Fpa      , Aa^Vha      , Ha          , Hh          , Aa^Fpa      , Aa          , Aa^Fpa      , Aa^Fpa      , Aa^Fpa      , Mm          , Mm^Xm       , Mm          , Mm          , Mm          , Mm^Xm       , Mm^Xm       , Mm^Xm       , Mm^Xm       
Mm          , Mm          , Mm          , Mm          , Mm          , Mm          , Mm          , Mm          , Gs^Fp       , Aa^Fpa      , Ha          , Aa          , Aa^Fpa      , Aa          , Aa^Fpa      , Hh          , Aa^Fpa      , Mm          , Mm^Vhh      , Mm          , Mm          , Mm          , Mm^Xm       , Mm^Xm       , Mm^Xm       , Mm^Xm       
Mm          , Mm          , Mm          , Mm          , Mm          , Mm          , Mm          , Mm          , Hh          , Aa^Fpa      , Aa          , Aa^Fpa      , Aa          , Hh          , Hh          , Gs^Fp       , Gs^Fp       , Aa^Fpa      , Mm          , Mm          , Mm          , Mm          , Mm^Xm       , Mm^Xm       , Mm^Xm       , Mm^Xm       
Mm          , Mm          , Mm          , Mm          , Mm          , Mm          , Mm          , Hh          , Gs^Fp       , Gs^Fp       , Gs^Fp       , Aa^Fpa      , Ha          , Ha          , Mm          , Mm          , Mm          , Mm          , Mm          , Mm          , Mm          , Mm          , Mm^Xm       , Mm^Xm       , Mm^Xm       , Mm^Xm       
Mm          , Mm          , Mm          , Mm          , Mm          , Mm          , Ha          , Aa^Fpa      , Hh          , Gs^Fp       , Gs^Fp       , Aa          , Aa^Fpa      , Aa^Fpa      , Mm          , Mm          , Aa^Fpa      , Mm          , Mm          , Mm          , Mm          , Mm          , Mm^Xm       , Mm^Xm       , Wo          , Ai          
Mm          , Mm          , Mm          , Mm          , Mm          , Mm          , Ha          , Aa^Fpa      , Hh          , Aa          , Gs          , Gs^Fp       , Aa^Fpa      , Aa^Fpa      , Aa^Vha      , Mm          , Aa^Fpa      , Aa^Fpa      , Mm          , Mm          , Mm          , Mm          , Mm^Xm       , Mm^Xm       , Ai          , Mm^Xm       
Mm          , Mm          , Mm          , Mm          , Mm          , Mm          , Mm          , Ha          , Hh          , Hh          , Gs          , Gs^Fp       , Gs^Fp       , Gs^Fp       , Hh          , Ha          , Aa^Fpa      , Aa^Fpa      , Mm          , Mm          , Mm          , Mm          , Wo          , Ai          , Wo          , Mm^Xm       
Mm          , Mm          , Mm          , Mm          , Mm^Vhh      , Mm          , Mm          , Mm          , Hh          , Aa^Fpa      , Gs^Fp       , Aa          , Aa          , Gs          , Hh          , Ha          , Mm          , Mm^Xm       , Mm          , Mm          , Ai          , Ai          , Ai          , Ai          , Wo          , Wo          
Mm          , Mm          , Mm          , Mm          , Mm          , Mm          , Aa^Fpa      , Aa^Fpa      , Ha          , Aa^Fpa      , Gs^Fp       , Gs^Fp       , Gs          , Aa          , Gs^Fp       , Aa^Fpa      , Ha          , Mm          , Mm          , Wo          , Wo          , Wo          , Mm^Xm       , Mm^Xm       , Mm^Xm       , Ai          
Mm          , Mm          , Mm          , Mm          , Mm          , Mm          , Mm          , Ha          , Ha          , Aa          , Aa^Vea      , Gs^Fp       , Rd          , Gs          , Gs          , Gs^Fp       , Ha          , Mm          , Ai          , Ai          , Wo          , Mm          , Mm^Xm       , Mm^Xm       , Mm^Xm       , Mm^Xm       
Mm          , Mm          , Mm          , Mm          , Mm          , Mm          , Mm          , Ha          , Ha          , Aa          , Hh          , Gs          , Rd          , Gs          , Gs          , Ha          , Ai          , Mm          , Wo          , Wo          , Mm          , Mm          , Mm^Xm       , Mm^Xm       , Mm^Xm       , Mm^Xm       
Mm          , Mm          , Mm          , Mm          , Mm          , Mm          , Mm          , Mm          , Mm          , Ha          , Wo          , Gs          , Wo^Bw|      , Ww          , Ww          , Ai          , Ai          , Ww          , Ww          , Ai          , Mm          , Mm          , Mm^Xm       , Mm^Xm       , Mm^Xm       , Mm^Xm       
Mm          , Mm          , Mm          , Mm          , Ai          , Mm          , Ai          , Mm          , Wo          , Ai          , Wo          , Ww          , Ai          , Wo          , Ai          , Wo          , Mm          , Wo          , Mm          , Mm          , Mm          , Mm          , Mm^Xm       , Mm^Xm       , Mm^Xm       , Mm^Xm       
Mm          , Mm          , Wo          , Ai          , Wo          , Wo          , Wo          , Wo          , Wo          , Wo          , Ha          , Ai          , Ha          , Ai          , Aa          , Ha          , Ha          , Mm          , Mm          , Mm          , Mm          , Mm          , Mm^Xm       , Mm^Xm       , Mm^Xm       , Mm^Xm       
Wo          , Wo          , Wo          , Wo          , Wo          , Wo          , Mm          , Wo          , Mm          , Mm          , Mm          , Hh          , Ha          , Aa          , Aa          , Aa          , Ai          , Ai          , Ai          , Mm          , Mm          , Mm          , Mm^Xm       , Mm^Xm       , Mm^Xm       , Mm^Xm       
Wo          , Wo          , Mm          , Ai          , Mm          , Ha          , Mm          , Mm          , Mm          , Mm          , Mm          , Hh          , Aa^Fpa      , Ha          , Aa^Vea      , Aa          , Ai          , Ai          , Mm          , Mm          , Mm          , Mm          , Mm^Xm       , Mm^Xm       , Mm^Xm       , Mm^Xm       
Ai          , Ai          , Mm          , Mm          , Mm          , Ha          , Ha          , Mm          , Mm          , Hh          , Hh          , Aa^Fpa      , Gs          , Gs          , Gs          , Aa          , Ha          , Ha          , Mm^Xm       , Mm          , Mm          , Mm          , Mm^Xm       , Mm^Xm       , Mm^Xm       , Mm^Xm       
Mm          , Mm          , Mm^Xm       , Mm          , Mm          , Mm          , Ha          , Mm          , Hh          , Hh          , Gs^Fp       , Aa^Fpa      , Gs^Fp       , Gs          , Gs          , Gs          , Ha          , Mm          , Mm          , Mm          , Mm          , Mm          , Mm^Xm       , Mm^Xm       , Mm^Xm       , Mm^Xm       
Mm          , Mm          , Mm          , Mm^Vhh      , Mm          , Mm          , Ha          , Ha          , Ha          , Aa^Fpa      , Gs^Fp       , Gs^Fp       , Gs^Fp       , Hh          , Ha          , Ha          , Mm          , Mm          , Mm          , Mm          , Mm          , Mm          , Mm^Xm       , Mm^Xm       , Mm^Xm       , Mm^Xm       
Mm          , Mm          , Mm          , Mm          , Mm          , Gs^Fp       , Mm          , Ha          , Gg^Ve       , Gs^Fp       , Aa^Fpa      , Aa^Fpa      , Aa^Fpa      , Hh          , Mm          , Ha          , Mm          , Mm^Vhh      , Mm          , Mm          , Mm          , Mm          , Mm^Xm       , Mm^Xm       , Mm^Xm       , Mm^Xm       
Mm          , Mm          , Mm          , Mm          , Mm          , Gs^Fp       , Hh          , Aa^Fpa      , Aa^Fpa      , Gg          , Gs^Fp       , Aa^Vha      , Aa^Fpa      , Hh          , Mm          , Ha          , Ha          , Mm          , Mm          , Mm          , Mm          , Mm          , Mm^Xm       , Mm^Xm       , Mm^Xm       , Mm^Xm       
Mm          , Mm          , Mm          , Mm          , Mm          , Mm          , Hh          , Aa^Fpa      , Gs          , Gg^Fet      , Hh          , Hh          , Hh          , Hh          , Mm          , Mm          , Ha          , Mm          , Mm          , Mm          , Mm          , Mm          , Mm^Xm       , Mm^Xm       , Mm^Xm       , Mm^Xm       
Mm          , Mm          , Mm          , Mm          , Ha          , Hh          , Gs^Fp       , Gs^Fp       , Gs          , Gg          , Gs^Fp       , Gs^Fp       , Mm^Xm       , Mm          , Mm          , Ha          , Ha          , Mm          , Mm          , Mm          , Mm          , Mm          , Mm^Xm       , Mm^Xm       , Mm^Xm       , Mm^Xm       
Mm          , Mm          , Mm          , Mm^Xm       , Mm          , Aa^Vha      , Gs          , Aa^Fpa      , Gs          , Hh          , Ha          , Mm          , Mm          , Mm          , Hh          , Gs^Fp       , Mm          , Hh          , Mm          , Mm          , Mm          , Mm          , Mm^Xm       , Mm^Xm       , Mm^Xm       , Mm^Xm       
Mm          , Mm          , Mm          , Mm          , Ha          , Gs^Fp       , Gs          , Gs          , Gs^Fp       , Ha          , Ha          , Mm          , Mm          , Mm          , Mm          , Hh          , Gs^Fp       , Gs^Fp       , Hh          , Mm          , Hh          , Mm          , Mm^Xm       , Mm^Xm       , Mm^Xm       , Mm^Xm       
Mm          , Mm          , Mm          , Mm^Vhh      , Ha          , Gs^Fp       , Gs          , Gs^Fp       , Gs^Fp       , Aa^Vea      , Gs^Fp       , Gs^Fp       , Mm          , Aa^Fpa      , Mm          , Mm          , Hh          , Gs^Fp       , Hh          , Hh          , Hh          , Mm          , Mm^Xm       , Mm^Xm       , Mm^Xm       , Mm^Xm       
Mm          , Mm          , Mm          , Mm          , Ha          , Ha          , Hh          , Gs          , Aa^Fpa      , Gs^Fp       , Gs^Fp       , Gs^Fp       , Hh          , Aa^Fpa      , Mm          , Mm          , Mm^Vhh      , Mm          , Mm          , Mm          , Mm          , Mm          , Mm^Xm       , Mm^Xm       , Mm^Xm       , Mm^Xm       
Mm          , Mm          , Mm          , Ha          , Mm          , Mm          , Hh          , Aa^Fpa      , Aa^Fpa      , Gs          , Gs          , Aa^Fpa      , Ha          , Ha          , Ha          , Mm          , Mm          , Mm          , Mm          , Mm          , Mm          , Mm          , Mm^Xm       , Mm^Xm       , Mm^Xm       , Mm^Xm       
Mm          , Mm          , Mm          , Mm          , Mm          , Mm          , Mm          , Hh          , Aa^Fpa      , Gs          , Gs          , Gs          , Hh          , Mm          , Mm          , Mm          , Mm          , Mm          , Mm          , Mm          , Mm          , Mm          , Mm^Xm       , Mm^Xm       , Mm^Xm       , Mm^Xm       
Mm^Xm       , Mm^Xm       , Mm^Xm       , Mm^Xm       , Mm^Xm       , Mm^Xm       , Mm          , Hh          , Hh          , Hh          , Gs          , Gs          , Hh          , Mm          , Mm^Xm       , Mm^Xm       , Mm^Xm       , Mm^Xm       , Mm^Xm       , Mm^Xm       , Mm^Xm       , Mm^Xm       , Mm^Xm       , Mm^Xm       , Mm^Xm       , Mm^Xm       
Mm^Xm       , Mm^Xm       , Mm^Xm       , Mm^Xm       , Mm^Xm       , Mm^Xm       , Mm          , Hh          , Hh          , Gs          , Ds          , Gs          , Hh          , Mm          , Mm          , Mm^Xm       , Mm^Xm       , Mm^Xm       , Mm^Xm       , Mm^Xm       , Mm^Xm       , Mm^Xm       , Mm^Xm       , Mm^Xm       , Mm^Xm       , Mm^Xm       
Mm^Xm       , Mm^Xm       , Mm^Xm       , Mm^Xm       , Mm^Xm       , Mm          , Hh          , Hh          , Gs          , Gs          , Ds          , Gs          , Hh          , Hh          , Mm          , Mm^Xm       , Mm^Xm       , Mm^Xm       , Mm^Xm       , Mm^Xm       , Mm^Xm       , Mm^Xm       , Mm^Xm       , Mm^Xm       , Mm^Xm       , Mm^Xm       
Mm^Xm       , Mm^Xm       , Mm^Xm       , Mm^Xm       , Mm          , Mm          , Mm^Xm       , Gs          , Ds          , Ds          , Gs          , Gs          , Mm^Xm       , Hh          , Hh          , Mm          , Mm^Xm       , Mm^Xm       , Mm^Xm       , Mm^Xm       , Mm^Xm       , Mm^Xm       , Mm^Xm       , Mm^Xm       , Mm^Xm       , Mm^Xm       
