border_size=1
usage=map

Md^Xm       , Md^Xm       , Md^Xm       , Md^Xm       , Md^Xm       , Md^Xm       , Md^Xm       , Md^Xm       , Md^Xm       , Md^Xm       , Md^Xm       , Md^Xm       , Md^Xm       , Md^Xm       , Md^Xm       , Md          , Md          , Md          , Rd          , Md^Xm       , Md^Xm       , Md^Xm       , Md^Xm       , Md^Xm       , Md^Xm       , Md^Xm       , Md^Xm       , Md^Xm       , Md^Xm       , Md^Xm       , Md^Xm       , Md^Xm       , Md^Xm       , Md^Xm       , Md^Xm       , Md^Xm       , Md^Xm       , Md          , Md^Xm       , Md^Xm       , Md^Xm       , Md          
Md^Xm       , Md^Xm       , Md^Xm       , Md^Xm       , Md^Xm       , Md^Xm       , Md^Xm       , Md^Xm       , Md          , Md^Xm       , Md^Xm       , Md^Xm       , Md^Xm       , Md^Xm       , Md^Xm       , Md          , Hd          , Ds          , Rd          , Md          , Md^Xm       , Md^Xm       , Md^Xm       , Md^Xm       , Md^Xm       , Md^Xm       , Md^Xm       , Md^Xm       , Md^Xm       , Md^Xm       , Md^Xm       , Md^Xm       , Md^Xm       , Md^Xm       , Md^Xm       , Md^Xm       , Md^Xm       , Md^Xm       , Md^Xm       , Md^Xm       , Md^Xm       , Md^Xm       
Md^Xm       , Md^Xm       , Md^Xm       , Md^Xm       , Md^Xm       , Md^Xm       , Md^Xm       , Md          , Md          , Md          , Md          , Md          , Md          , Md^Xm       , Md          , Hd          , Hd          , Ds          , Rd          , Hd          , Md          , Md^Xm       , Md          , Md          , Md          , Md          , Md          , Md          , Md          , Md          , Md          , Md^Xm       , Md          , Md^Xm       , Md^Xm       , Md^Xm       , Md^Xm       , Md^Xm       , Md^Xm       , Md^Xm       , Md^Xm       , Md^Xm       
Md          , Md^Xm       , Md          , Md^Xm       , Md^Xm       , Md^Xm       , Md          , Md          , Hd          , Hd          , Hd          , Md          , Hd          , Md          , Md          , Md          , Rd          , Rd          , Hd          , Hd          , Md          , Md          , Md          , Md          , Dd          , Dd          , Dd          , Md          , Md          , Md          , Md          , Md          , Md          , Md          , Md          , Md          , Md          , Md^Xm       , Md^Xm       , Md^Xm       , Md^Xm       , Md^Xm       
Md          , Md          , Md          , Md          , Md          , Md          , Md          , Hd          , Md          , Md          , Hd          , Hd          , Hd          , Hd          , Dd^Vdt      , Hd          , Rd          , Ds          , Md          , Md          , Md          , Md          , Md          , Md          , Dd          , Dd          , Re          , Dd          , Dd          , Dd          , Dd          , Dd          , Dd          , Md          , Dd          , Md          , Md          , Md          , Md^Xm       , Md^Xm       , Md^Xm       , Md^Xm       
Md          , Md          , Md          , Md          , Md          , Md          , Md          , Hd          , Hd          , Hd          , Dd          , Hd          , Dd          , Hd          , Dd          , Rd          , Ce          , Ce          , Ce          , Dd          , Dd^Vdt      , Dd          , Dd^Dc       , Dd          , Dd          , Dd          , Dd          , Dd          , Dd          , Dd          , Re          , Dd          , Dd          , Dd          , Dd          , Md          , Md          , Md          , Md          , Md^Xm       , Md^Xm       , Md^Xm       
Md          , Md          , Md          , Md          , Hd          , Hd          , Dd          , Hd          , Re          , Dd          , Rd          , Rd          , Zw          , Dd^Dc       , Dd^Vdt      , Dd          , Ce          , 1 Ke        , Ce          , Hd          , Dd          , Dd          , Dd          , Re          , Re          , Re          , Dd          , Re          , Zw          , Re          , Re^Uf       , Dd          , Uh          , Dd          , Dd          , Dd          , Md          , Md          , Md          , Md^Xm       , Md^Xm       , Md^Xm       
Hd          , Hd          , Hd          , Hd          , Zw          , Rd          , Rd          , Re          , Rd          , Rd          , Dd          , Dd          , Dd^Dc       , Zw          , Re          , Re          , Dd^Vdt      , Ce          , Re          , Dd          , Dd^Vdt      , Dd          , Re          , Uh          , Uh          , Zw          , Rd          , Zw          , Rd          , Re^Uf       , Re^Uf       , Re^Uf       , Uh          , Uu          , Uu          , Dd          , Dd          , Md          , Md          , Md          , Md          , Md^Xm       
Hd          , Hd          , Hd          , Dd          , Zw          , Zw          , Rd          , Re          , Re          , Re          , Rd          , Dd          , Dd          , Re          , Rd          , Rd          , Dd          , Dd^Dc       , Dd          , Re          , Re          , Dd          , Dd          , Dd          , Re          , Rd          , Re          , Rd          , Re          , Re^Uf       , Re^Uf       , Uh          , Re^Uf       , Uu^Uf       , Uu          , Uu          , Re^Uf       , Dd          , Dd          , Md          , Md          , Md          
Dd          , Hd          , Hd          , Dd          , Rd          , Rd          , Dd          , Dd          , Re          , Dd          , Dd^Dc       , Rd          , Rd          , Rd          , Dd          , Dd          , Dd^Dc       , Uh          , Uh          , Dd          , Dd^Dc       , Dd          , Uh          , Uh          , Dd^Dc       , Dd          , Rd          , Rd          , Re          , Re^Uf       , Re^Uf       , Re^Uf       , Uh          , Uh          , Yr          , Uu          , Re^Uf       , Rd          , Dd          , Dd          , Dd          , Md          
Dd          , Rd          , Rd          , Dd          , Dd          , Rd          , Dd          , Dd^Dc       , Ds          , Dd          , Rd          , Re          , Rd          , Re          , Dd          , Zw          , Qxv         , Zw          , Zw          , Dd          , Dd          , Uh          , Uh          , Dd          , Zw          , Zw          , Zw          , Rd          , Re          , Re^Uf       , Re^Uf       , Re^Uf       , Rd          , Uu^Uf       , Yr          , Re^Uf       , Rd          , Re          , Dd          , Dd          , Dd          , Dd          
Re          , Rd          , Rd          , Dd          , Re^Uf       , Rd          , Uu^Vud      , Zw          , Zw          , Ds          , Rd          , Rd          , Rd          , Re          , Rd          , Yrh         , Yr          , Qxv         , Qxv         , Uu^Vud      , Zw          , Uh          , Zw          , Zw          , Qxv         , Qxv         , Qxv         , Zw          , Dd          , Rd          , Rd          , Re          , Re          , Re^Uf       , Yrh         , Yr          , Dd          , Re          , Dd          , Dd          , Dd          , Dd          
Re          , Re          , Re^Uf       , Re^Uf       , Zw          , Zw          , Qxv         , Qxv         , Qxv         , Zw          , Dd^Dc       , Re^Uf       , Re^Uf       , Rd          , Rd          , Yr          , Yrh         , Qxv         , Yrh         , Yr          , Uh          , Zw          , Uh          , Zw          , Zw          , Qxv         , Qxv         , Zw          , Zw          , Re          , Yr          , Yr          , Re          , Rd          , Yr          , Rd          , Dd          , Re          , Dd          , Dd          , Dd          , Dd          
Dd          , Rd          , Re^Uf       , Dd          , Zw          , Qxv         , Qxv         , Qxv         , Zw          , Zw          , Re^Uf       , Re^Uf       , Rd          , Rd          , Dd^Dc       , Rd          , Yr          , Yr          , Uh          , Yr          , Uu^Uf       , Uu^Uf       , Zw          , Zw          , Zw          , Qxv         , Qxv         , Uu^Vud      , Uh          , Uh          , Dd          , Yr          , Re          , Re          , Yr          , Re          , Re          , Dd          , Dd          , Dd          , Dd          , Dd          
Dd          , Rd          , Dd          , Zw          , Zw          , Qxv         , Qxv         , Qxv         , Zw          , Zw          , Zw          , Re^Uf       , Re^Uf       , Dd          , Uh          , Rd          , Zw          , Yrh         , Dd          , Uu^Uf       , Uh          , Uu^Uf       , Zw          , Uh          , Zw          , Zw          , Zw          , Zw          , Uh          , Dd          , Re          , Re          , Rd          , Rd          , Yr          , Re          , Re          , Re          , Re          , Dd          , Dd          , Dd          
Dd          , Rd          , Dd          , Zw          , Zw          , Qxv         , Qxv         , Zw          , Zw          , Zw          , Uh          , Zw          , Qxv         , Zw          , Zw          , Uh          , Zw          , Uh          , Dd          , Dd^Dc       , Zw          , Zw          , Uh          , Uh          , Dd          , Uu^Vu       , Rd          , Dd          , Uh          , Re          , Yr          , Yr          , Zw          , Zw          , Rd          , Dd          , Re          , Dd          , Dd          , Dd          , Dd          , Dd          
Dd          , Rd          , Re          , Ds          , Zw          , Qxv         , Zw          , Zw          , Uh          , Uu^Uf       , Uu^Uf       , Zw          , Zw          , Qxv         , Zw          , Uu^Vu       , Zw          , Uh          , Uu^Uf       , Dd          , Zw          , Zw          , Uu^Vud      , Uh          , Dd          , Re          , Re          , Rd          , Rd          , Re          , Yr          , Yr          , Qxv         , Qxv         , Rd          , Rd          , Rd          , Dd          , Re          , Dd          , Dd          , Dd          
Dd          , Re          , Re          , Zw          , Zw          , Qxv         , Zw          , Zw          , Re          , Uh          , Uh          , Uu^Vud      , Zw          , Uh          , Uh          , Zw          , Dd          , Uh          , Uu^Uf       , Re^Uf       , Uh          , Re^Uf       , Re^Uf       , Zw          , Zw          , Re          , Re          , Dd          , Rd          , Dd          , Uh          , Uu^Vud      , Qxv         , Qxv         , Qxv         , Uu          , Rd          , Rd          , Dd          , Dd          , Dd          , Dd          
Dd          , Dd          , Zw          , Dd          , Re^Uf       , Zw          , Ds          , Re^Uf       , Re^Uf       , Dd^Dc       , Uh          , Zw          , Zw          , Zw          , Uh          , Uh          , Zw          , Uh          , Yr          , Re^Uf       , Re^Uf       , Uu^Uf       , Re^Uf       , Zw          , Yr          , Yr          , Re          , Rd          , Rd          , Rd          , Rd          , Zw          , Zw          , Qxv         , Qxv         , Rd          , Yr          , Re          , Dd          , Dd          , Dd          , Dd          
Dd          , Dd          , Re          , Zw          , Zw          , Re          , Re          , Ds          , Re^Uf       , Uh          , Zw          , Zw          , Re          , Zw          , Zw          , Zw          , Uh          , Yr          , Uu^Uf       , Yr          , Yr          , Uh          , Uh          , Zw          , Yr          , Zw          , Uh          , Rd          , Uh          , Rd          , Uh          , Zw          , Zw          , Qxv         , Re^Uf       , Zw          , Rd          , Yr          , Yr          , Dd          , Dd          , Dd          
Dd          , Dd          , Re          , Zw          , Re^Uf       , Ds          , Ds          , Dd          , Uh          , Uu^Vu       , Zw          , Zw          , Rd          , Dd          , Yrh         , Yr          , Yr          , Yr          , Yr          , Uu^Uf       , Yr          , Yr          , Chr         , Yr          , Yr          , Uh          , Zw          , Rd          , Zw          , Uh          , Uh          , Uh          , Zw          , Zw          , Uu^Uf       , Re^Uf       , Rd          , Yr          , Yr          , Rd          , Dd^Dc       , Dd          
Dd          , Dd          , Dd          , Ds          , Re          , Re          , Zw          , Ds          , Zw          , Zw          , Qxv         , Uh          , Re^Uf       , Rd          , Chr         , Uu^Vud      , Yr          , Chr         , Qxv         , Yr          , Chr         , Yr          , Dd^Dr       , Khr         , Chr         , Yr          , Chr         , Zw          , Qxv         , Zw          , Qxv         , Zw          , Qxv         , Zw          , Uu^Uf       , Uu^Uf       , Re^Uf       , Dd          , Dd          , Dd          , Dd          , Dd          
Dd          , Dd          , Zw          , Zw          , Zw          , Zw          , Qxv         , Qxv         , Qxv         , Zw          , Uh          , Uh          , Re^Uf       , Re^Uf       , Yr          , Yr          , Yrh         , Yr          , Qxv         , Qxv         , Qxv         , Qxv         , Chr         , Yr          , Yr          , Yr          , Yrh         , Chr         , Qxv         , Qxv         , Qxv         , Qxv         , Zw          , Zw          , Zw          , Uu^Vud      , Re^Uf       , Dd          , Rd          , Rd          , Dd          , Dd          
Dd          , Zw          , Zw          , Qxv         , Uh          , Zw          , Zw          , Zw          , Zw          , Zw          , Zw          , Zw          , Yrh         , Chr         , 2 Khr       , Chr         , Yr          , Yr          , Chr         , Khr         , Qxv         , Chr         , Chr         , Dd^Dr       , Yr          , 3 Khr       , Chr         , Chr         , Qxv         , Zw          , Zw          , Zw          , Yr          , Yr          , Zw          , Qxv         , Re          , Rd          , Rd          , Dd          , Dd          , Dd          
Dd          , Dd          , Dd          , Zw          , Dd          , Uh          , Yr          , Zw          , Uh          , Re^Uf       , Re^Uf       , Yr          , Yr          , Chr         , Chr         , Rd          , Chr         , Chr         , Qxv         , Chr         , Qxv         , Khr         , Dd^Dr       , Uu^Vud      , Yr          , Chr         , Qxv         , Qxv         , Qxv         , Zw          , Zw          , Uu^Vu       , Uh          , Yrh         , Uh          , Re          , Re^Uf       , Rd          , Dd          , Rd          , Dd          , Dd          
Dd          , Dd          , Hd          , Dd          , Dd          , Yr          , Yr          , Yrh         , Re^Uf       , Dd          , Hd          , Rd          , Yr          , Yrh         , Yrh         , Dd          , Zw          , Qxv         , Qxv         , Chr         , Qxv         , Qxv         , Yr          , Yr          , Khr         , Qxv         , Qxv         , Chr         , Qxv         , Zw          , Uh          , Yr          , Yr          , Yr          , Yr          , Re^Uf       , Uu^Uf       , Rd          , Zw          , Dd          , Dd          , Dd          
Dd          , Hd          , Hd          , Dd          , Zw          , Uh          , Uu^Vud      , Yr          , Rd          , Rd          , Dd          , Rd          , Yrh         , Yr          , Zw          , Zw          , Qxv         , Qxv         , Qxv         , Chr         , Qxv         , Chr         , Chr         , Yr          , Chr         , Qxv         , Chr         , Qxv         , Zw          , Zw          , Uu^Uf       , Zw          , Yr          , Yrh         , Yr          , Re^Uf       , Uh          , Uu^Uf       , Zw          , Zw          , Dd          , Dd          
Dd          , Dd          , Hd          , Dd          , Zw          , Zw          , Dd          , Dd          , Dd          , Dd^Dc       , Yr          , Yr          , Uh          , Yrh         , Uh          , Zw          , Qxv         , Qxv         , Qxv         , Khr         , Qxv         , Qxv         , Zw          , Yrh         , Yr          , Qxv         , Qxv         , Qxv         , Zw          , Uu^Vud      , Uu^Uf       , Uh          , Yrh         , Yr          , Yr          , Zw          , Zw          , Uu^Uf       , Zw          , Dd          , Dd          , Dd          
Dd          , Dd          , Dd          , Hd          , Ds          , Uh          , Uh          , Ds          , Zw          , Zw          , Yr          , Yrh         , Uh          , Uh          , Uh          , Zw          , Zw          , Zw          , Qxv         , Qxv         , Qxv         , Zw          , Zw          , Uh          , Uh          , Qxv         , Qxv         , Zw          , Qxv         , Zw          , Uh          , Re^Uf       , Yr          , Uh          , Uh          , Uu^Vud      , Zw          , Zw          , Yr          , Dd          , Dd          , Dd          
Dd          , Uh          , Dd          , Dd          , Ds          , Ds          , Uh          , Zw          , Qxv         , Qxv         , Qxv         , Uu^Vu       , Uh          , Zw          , Yr          , Zw          , Dd          , Zw          , Uu^Vud      , Qxv         , Qxv         , Qxv         , Zw          , Zw          , Uh          , Qxv         , Uu          , Qxv         , Qxv         , Uh          , Yrh         , Re^Uf       , Uh          , Re^Uf       , Re^Uf       , Re^Uf       , Re^Uf       , Yrh         , Dd          , Yr          , Dd          , Dd          
Dd          , Dd          , Dd          , Dd          , Dd          , Yr          , Yr          , Zw          , Zw          , Qxv         , Qxv         , Zw          , Uh          , Yr          , Yr          , Dd          , Zw          , Zw          , Zw          , Qxv         , Zw          , Zw          , Zw          , Qxv         , Uu          , Uu          , Uh          , Qxv         , Qxv         , Yrh         , Yrh         , Yr          , Uh          , Re^Uf       , Uh          , Re^Uf       , Re^Uf       , Re          , Re          , Rd          , Rd          , Dd          
Dd          , Dd          , Dd          , Uh          , Uh          , Yrh         , Yr          , Zw          , Zw          , Qxv         , Qxv         , Zw          , Yr          , Yr          , Dd          , Yr          , Zw          , Uh          , Uh          , Yrh         , Yr          , Uh          , Zw          , Qxv         , Qxv         , Uu^Vu       , Zw          , Zw          , Zw          , Zw          , Zw          , Uh          , Uh          , Zw          , Zw          , Zw          , Zw          , Uh          , Uh          , Dd          , Rd          , Dd          
Dd          , Dd          , Re          , Zw          , Uu^Vud      , Dd          , Re^Uf       , Re          , Uh          , Zw          , Uh          , Zw          , Zw          , Dd          , Zw          , Yr          , Yrh         , Zw          , Dd          , Yr          , Yr          , Rd          , Uh          , Qxv         , Qxv         , Yr          , Yrh         , Rd          , Uh          , Uu^Uf       , Uh          , Zw          , Uh          , Zw          , Zw          , Qxv         , Zw          , Uu^Vud      , Dd          , Rd          , Dd          , Dd          
Dd          , Dd          , Re          , Dd          , Zw          , Zw          , Re^Uf       , Rd          , Rd          , Uh          , Uh          , Zw          , Re          , Zw          , Yr          , Yr          , Yr          , Yr          , Yr          , Yr          , Yr          , Yrh         , Uh          , Zw          , Zw          , Yr          , Yr          , Re          , Uu^Uf       , Re^Uf       , Uh          , Zw          , Zw          , Zw          , Uh          , Qxv         , Qxv         , Zw          , Uh          , Dd          , Rd          , Dd          
Hd          , Hd          , Dd          , Rd          , Rd          , Re          , Dd          , Re^Uf       , Dd          , Zw          , Rd          , Rd          , Re          , Yr          , Uh          , Zw          , Uh          , Dd          , Rd          , Yr          , Yr          , Yr          , Yr          , Yr          , Yrh         , Uh          , Yrh         , Yr          , Dd          , Zw          , Zw          , Zw          , Qxv         , Zw          , Uu^Vu       , Zw          , Uh          , Re^Uf       , Yrh         , Rd          , Dd          , Dd          
Hd          , Hd          , Uh          , Uh          , Yr          , Rd          , Zw          , Uh          , Zw          , Zw          , Re^Uf       , Rd          , Rd          , Rd          , Zw          , Zw          , Zw          , Re          , Uh          , Yr          , Yrh         , Uh          , Zw          , Yr          , Yr          , Zw          , Yr          , Yr          , Uh          , Uh          , Zw          , Qxv         , Qxv         , Zw          , Zw          , Uu^Uf       , Yr          , Yrh         , Yrh         , Rd          , Dd          , Hd          
Dd          , Hd          , Dd          , Rd          , Yr          , Rd          , Zw          , Uh          , Re^Uf       , Re^Uf       , Uh          , Ds          , Dd          , Rd          , Uh          , Qxv         , Qxv         , Zw          , Uh          , Yr          , Yr          , Rd          , Uh          , Zw          , Uh          , Yr          , Dd          , Yrh         , Zw          , Uh          , Zw          , Qxv         , Qxv         , Yrh         , Zw          , Uu^Uf       , Uu^Uf       , Yr          , Yr          , Dd          , Hd          , Hd          
Dd          , Dd          , Dd          , Dd          , Yr          , Yrh         , Zw          , Zw          , Ds          , Re^Uf       , Ds          , Rd          , Rd          , Uh          , Uu^Vud      , Qxv         , Qxv         , Zw          , Zw          , Uh          , Zw          , Re          , Dd          , Uh          , Uh          , Dd          , Re          , Zw          , Qxv         , Zw          , Zw          , Yrh         , Qxv         , Qxv         , Uu^Vud      , Zw          , Yr          , Yrh         , Yr          , Yr          , Yr          , Hd          
Dd          , Ds          , Ds          , Rd          , Qxv         , Qxv         , Qxv         , Qxv         , Zw          , Re^Uf       , Zw          , Ds          , Zw          , Uh          , Zw          , Qxv         , Zw          , Qxv         , Zw          , Uh          , Zw          , Uu^Vu       , Zw          , Uh          , Zw          , Zw          , Zw          , Zw          , Qxv         , Qxv         , Zw          , Yr          , Uh          , Qxv         , Zw          , Rd          , Yr          , Yr          , Yr          , Dd          , Dd          , Md^Xm       
Dd          , Dd          , Dd          , Zw          , Zw          , Zw          , Zw          , Qxv         , Zw          , Zw          , Uh          , Zw          , Re^Uf       , Zw          , Re^Uf       , Zw          , Uh          , Zw          , Qxv         , Zw          , Dd          , Zw          , Re^Uf       , Re^Uf       , Re^Uf       , Re          , Re^Uf       , Zw          , Uh          , Qxv         , Uu^Vu       , Uh          , Re^Uf       , Zw          , Re^Uf       , Re^Uf       , Re^Uf       , Yrh         , Yr          , Yrh         , Dd          , Md^Xm       
Dd          , Uu          , Dd          , Ds          , Uh          , Uh          , Uh          , Zw          , Dd          , Uh          , Dd          , Uh          , Dd          , Re^Uf       , Dd          , Dd          , Zw          , Zw          , Zw          , Uh          , Ds          , Dd          , Ds          , Re^Uf       , Ds          , Re^Uf       , Dd          , Ds          , Uh          , Zw          , Dd          , Dd          , Dd          , Re^Uf       , Uh          , Re^Uf       , Hd          , Re^Uf       , Ds          , Dd          , Dd          , Dd          
Dd          , Dd          , Dd          , Dd          , Dd          , Dd          , Dd          , Dd          , Dd          , Dd          , Dd          , Dd          , Hd          , Hd          , Hd          , Hd          , Hd          , Hd          , Hd          , Zw          , Dd          , Ds          , Ds          , Ds          , Ds          , Ds          , Dd          , Dd          , Dd          , Dd          , Dd          , Dd          , Uh          , Uh          , Zw          , Zw          , Hd          , Dd          , Ds          , Ds          , Dd          , Dd          
