border_size=1
usage=map

_off^_usr   , _off^_usr   , _off^_usr   , _off^_usr   , _off^_usr   , _off^_usr   , _off^_usr   , _off^_usr   , _off^_usr   , _off^_usr   , _off^_usr   , _off^_usr   , _off^_usr   , _off^_usr   , _off^_usr   , _off^_usr   , _off^_usr   , _off^_usr   , _off^_usr   , _off^_usr   , _off^_usr   , _off^_usr   , _off^_usr   , _off^_usr   , _off^_usr   , _off^_usr   , _off^_usr   , _off^_usr   , _off^_usr   , _off^_usr   , _off^_usr   , _off^_usr   , Dd          , Dd          , Dd          , Dd          , Zw          , Zw          , Zw          , Yr          , Yr          , Yr          
_off^_usr   , _off^_usr   , _off^_usr   , _off^_usr   , _off^_usr   , _off^_usr   , _off^_usr   , _off^_usr   , _off^_usr   , _off^_usr   , _off^_usr   , _off^_usr   , _off^_usr   , _off^_usr   , _off^_usr   , _off^_usr   , _off^_usr   , _off^_usr   , _off^_usr   , _off^_usr   , _off^_usr   , _off^_usr   , _off^_usr   , _off^_usr   , _off^_usr   , _off^_usr   , _off^_usr   , _off^_usr   , _off^_usr   , _off^_usr   , Dd          , Dd          , Dd          , Dd          , Dd          , Dd          , Dd          , Zw          , Zw          , Yrh         , Dd^Do       , Dd          
_off^_usr   , _off^_usr   , _off^_usr   , _off^_usr   , _off^_usr   , _off^_usr   , _off^_usr   , _off^_usr   , _off^_usr   , _off^_usr   , _off^_usr   , _off^_usr   , _off^_usr   , _off^_usr   , _off^_usr   , _off^_usr   , _off^_usr   , _off^_usr   , _off^_usr   , _off^_usr   , _off^_usr   , _off^_usr   , _off^_usr   , _off^_usr   , _off^_usr   , _off^_usr   , _off^_usr   , _off^_usr   , Dd          , Dd          , Dd          , Dd          , Zw          , Dd          , Dd          , Dd          , Dd^Do       , Zw          , Zw          , Yr          , Dd          , Dd          
_off^_usr   , _off^_usr   , _off^_usr   , _off^_usr   , _off^_usr   , _off^_usr   , _off^_usr   , _off^_usr   , _off^_usr   , _off^_usr   , _off^_usr   , _off^_usr   , _off^_usr   , _off^_usr   , _off^_usr   , _off^_usr   , _off^_usr   , _off^_usr   , _off^_usr   , _off^_usr   , _off^_usr   , _off^_usr   , _off^_usr   , _off^_usr   , _off^_usr   , _off^_usr   , Zw          , Zw          , Yrh         , Dd          , Dd^Dc       , Dd          , Zw          , Zw          , Zw          , Dd          , Dd          , Yr          , Yrh         , Zw          , Yr          , Dd          
_off^_usr   , _off^_usr   , _off^_usr   , _off^_usr   , _off^_usr   , _off^_usr   , _off^_usr   , _off^_usr   , _off^_usr   , _off^_usr   , _off^_usr   , _off^_usr   , _off^_usr   , _off^_usr   , _off^_usr   , _off^_usr   , _off^_usr   , _off^_usr   , _off^_usr   , _off^_usr   , _off^_usr   , _off^_usr   , _off^_usr   , _off^_usr   , Dd          , Dd          , Dd          , Zw          , Yr          , Dd          , Zw          , Dd          , Yr          , Yr          , Zw          , Dd          , Zw          , Yr          , Yr          , Zw          , Zw          , Dd          
_off^_usr   , _off^_usr   , _off^_usr   , _off^_usr   , _off^_usr   , _off^_usr   , _off^_usr   , _off^_usr   , _off^_usr   , _off^_usr   , _off^_usr   , _off^_usr   , _off^_usr   , _off^_usr   , _off^_usr   , _off^_usr   , _off^_usr   , _off^_usr   , _off^_usr   , _off^_usr   , _off^_usr   , _off^_usr   , Dd          , Dd          , Dd          , Dd          , Dd          , Dd          , Dd          , Dd          , Dd          , Yr          , Zw          , Yrh         , Yr          , Dd          , Dd          , Zw          , Yr          , Yr          , Dd^Dc       , Dd          
_off^_usr   , _off^_usr   , _off^_usr   , _off^_usr   , _off^_usr   , _off^_usr   , _off^_usr   , _off^_usr   , _off^_usr   , _off^_usr   , _off^_usr   , _off^_usr   , _off^_usr   , _off^_usr   , _off^_usr   , _off^_usr   , _off^_usr   , _off^_usr   , _off^_usr   , _off^_usr   , Dd          , Zw          , Zw          , Zw          , Zw          , Zw          , Yr          , Dd          , Dd          , Dd          , Dd          , Yr          , Zw          , Zw          , Yr          , Dd          , Dd          , Dd          , Dd          , Dd          , Dd          , Dd          
_off^_usr   , _off^_usr   , _off^_usr   , _off^_usr   , _off^_usr   , _off^_usr   , _off^_usr   , _off^_usr   , _off^_usr   , _off^_usr   , _off^_usr   , _off^_usr   , _off^_usr   , _off^_usr   , _off^_usr   , _off^_usr   , _off^_usr   , _off^_usr   , Dd          , Dd          , Zw          , Zw          , Zw          , Zw          , Zw          , Yrh         , Yr          , Dd          , Dd          , Dd          , Zw          , Yr          , Dd^Do       , Zw          , Yr          , Zw          , Dd          , Dd          , Zw          , Dd          , Zw          , Zw          
_off^_usr   , _off^_usr   , _off^_usr   , _off^_usr   , _off^_usr   , _off^_usr   , _off^_usr   , _off^_usr   , _off^_usr   , _off^_usr   , _off^_usr   , _off^_usr   , _off^_usr   , _off^_usr   , _off^_usr   , _off^_usr   , Dd          , Dd          , Dd          , Dd          , Zw          , Zw          , Dd          , Zw          , Zw          , Zw          , Yr          , Zw          , Zw          , Zw          , Dd          , Zw          , Zw          , Dd          , Zw          , Yrh         , Dd          , Dd          , Dd          , Yr          , Zw          , Zw          
_off^_usr   , _off^_usr   , _off^_usr   , _off^_usr   , _off^_usr   , _off^_usr   , _off^_usr   , _off^_usr   , _off^_usr   , _off^_usr   , _off^_usr   , _off^_usr   , _off^_usr   , _off^_usr   , Dd          , Yr          , Dd          , Dd          , Dd          , Dd          , Dd          , Dd          , Dd          , Yr          , Zw          , Yr          , Yr          , Dd          , Dd          , Dd          , Dd          , Dd          , Dd          , Dd          , Dd          , Zw          , Zw          , Zw          , Dd          , Yrh         , Zw          , Zw          
_off^_usr   , _off^_usr   , _off^_usr   , _off^_usr   , _off^_usr   , _off^_usr   , _off^_usr   , _off^_usr   , _off^_usr   , _off^_usr   , _off^_usr   , _off^_usr   , Dd          , Dd          , Dd          , Yrh         , Yr          , Dd          , Zw          , Dd          , Zw          , Dd          , Yrh         , Yr          , Zw          , Yr          , Dd          , Dd          , Zw          , Dd          , 1 Dd        , Dd          , Dd          , Dd          , Dd          , Zw          , Zw          , Zw          , Dd          , Yr          , Dd^Do       , Dd          
_off^_usr   , _off^_usr   , _off^_usr   , _off^_usr   , _off^_usr   , _off^_usr   , _off^_usr   , _off^_usr   , _off^_usr   , _off^_usr   , Dd          , Dd          , Dd          , Dd          , Dd          , Yr          , Zw          , Dd          , Dd          , Zw          , Zw          , Zw          , Yr          , Zw          , Dd          , Dd^Do       , Dd          , Zw          , Dd          , Dd          , Dd          , Dd          , Dd          , Dd          , Zw          , Yr          , Yrh         , Yr          , Dd          , Dd          , Dd          , Dd          
_off^_usr   , _off^_usr   , _off^_usr   , _off^_usr   , _off^_usr   , _off^_usr   , _off^_usr   , _off^_usr   , Zw          , Dd          , Dd          , Dd          , Zw          , Yr          , Dd^Do       , Dd          , Zw          , Zw          , Zw          , Yr          , Zw          , Yr          , Zw          , Zw          , Dd          , Zw          , Dd          , Zw          , Zw          , Dd          , Dd          , Dd          , Dd          , Dd          , Zw          , Yr          , Yr          , Dd          , Zw          , Zw          , Dd          , Dd          
_off^_usr   , _off^_usr   , _off^_usr   , _off^_usr   , _off^_usr   , _off^_usr   , Zw          , Zw          , Zw          , Zw          , Zw          , Yrh         , Yr          , Yr          , Dd          , Dd          , Dd          , Zw          , Yrh         , Yr          , Dd          , Zw          , Dd          , Dd          , Dd          , Dd^Dc       , Dd          , Yrh         , Zw          , Zw          , Dd          , Zw          , Zw          , Dd^Dc       , Dd          , Zw          , Yrh         , Dd          , Dd          , Zw          , Dd          , Dd          
_off^_usr   , _off^_usr   , _off^_usr   , _off^_usr   , Dd          , Yr          , Zw          , Zw          , Dd          , Zw          , Zw          , Yr          , Zw          , Zw          , Dd          , Dd^Dc       , Dd          , Dd          , Yr          , Dd          , Dd          , Dd          , Dd          , Dd          , Zw          , Dd          , Yr          , Yr          , Zw          , Zw          , Dd          , Zw          , Dd          , Dd          , Dd          , Yr          , Zw          , Dd          , Zw          , Dd          , _off^_usr   , _off^_usr   
_off^_usr   , _off^_usr   , Dd          , Dd          , Yr          , Yr          , Zw          , Yr          , Dd          , Zw          , Yr          , Dd          , Dd          , Zw          , Zw          , Dd          , Dd          , Zw          , Zw          , Yr          , Yr          , Zw          , Dd          , Dd          , Dd          , Zw          , Zw          , Yr          , Zw          , Dd          , Dd          , Dd          , Yrh         , Yr          , Dd          , Zw          , Zw          , Zw          , _off^_usr   , _off^_usr   , _off^_usr   , _off^_usr   
Zw          , Zw          , Dd          , Dd          , Zw          , Zw          , Yr          , Dd          , Dd          , Yr          , Yr          , Dd          , Dd          , Zw          , Dd          , Dd          , Dd          , Zw          , Yr          , Yr          , Zw          , Yr          , Zw          , Zw          , Dd          , Dd          , Yr          , Zw          , Zw          , Zw          , Dd          , Yr          , Zw          , Dd^Do       , Zw          , Zw          , _off^_usr   , _off^_usr   , _off^_usr   , _off^_usr   , _off^_usr   , _off^_usr   
Dd          , Yr          , Yr          , Dd          , Yr          , Yr          , Dd          , Dd          , Dd          , Dd          , Yr          , Zw          , Yr          , Dd          , Dd          , Dd          , Dd          , Dd          , Yr          , Dd          , Dd          , Yr          , Yrh         , Zw          , Dd^Do       , Dd          , Dd          , Yr          , Yr          , Zw          , Yr          , Zw          , Zw          , Zw          , _off^_usr   , _off^_usr   , _off^_usr   , _off^_usr   , _off^_usr   , _off^_usr   , _off^_usr   , _off^_usr   
Dd          , Dd^Dc       , Yr          , Yr          , Yr          , Yrh         , Dd          , Dd          , Dd          , Zw          , Zw          , Yr          , Yrh         , Yr          , Dd          , Dd^Do       , Dd          , Zw          , Yr          , Yr          , Dd          , Zw          , Zw          , Zw          , Zw          , Zw          , Dd          , Zw          , Dd          , Zw          , Yr          , Zw          , _off^_usr   , _off^_usr   , _off^_usr   , _off^_usr   , _off^_usr   , _off^_usr   , _off^_usr   , _off^_usr   , _off^_usr   , _off^_usr   
Zw          , Zw          , Yr          , Yr          , Zw          , Zw          , Dd          , Yr          , Zw          , Zw          , Zw          , Dd          , Dd          , Yrh         , Dd          , Dd          , Yrh         , Yr          , Dd          , Dd          , Zw          , Dd          , Zw          , Zw          , Zw          , Zw          , Dd          , Dd          , Dd          , Dd          , _off^_usr   , _off^_usr   , _off^_usr   , _off^_usr   , _off^_usr   , _off^_usr   , _off^_usr   , _off^_usr   , _off^_usr   , _off^_usr   , _off^_usr   , _off^_usr   
Zw          , Zw          , Yr          , Yr          , Zw          , Zw          , Dd          , Dd          , Zw          , Zw          , Dd          , Dd          , Dd          , Yrh         , Yr          , Yr          , Yr          , Yr          , Zw          , Dd^Dc       , Dd          , Dd          , Yr          , Yr          , Zw          , Yrh         , Zw          , Dd          , _off^_usr   , _off^_usr   , _off^_usr   , _off^_usr   , _off^_usr   , _off^_usr   , _off^_usr   , _off^_usr   , _off^_usr   , _off^_usr   , _off^_usr   , _off^_usr   , _off^_usr   , _off^_usr   
Dd          , Dd          , Dd          , Dd          , Zw          , Dd          , Dd          , Yr          , Yr          , Zw          , Dd          , Dd          , Dd          , Yr          , Yr          , Zw          , Dd          , Zw          , Zw          , Dd          , Dd          , Dd          , Dd          , Yr          , Yr          , Zw          , _off^_usr   , _off^_usr   , _off^_usr   , _off^_usr   , _off^_usr   , _off^_usr   , _off^_usr   , _off^_usr   , _off^_usr   , _off^_usr   , _off^_usr   , _off^_usr   , _off^_usr   , _off^_usr   , _off^_usr   , _off^_usr   
Dd          , Dd          , Yrh         , Dd          , Dd          , Dd          , Zw          , Yr          , Yr          , Dd          , Dd^Do       , Yr          , Dd          , Dd          , Yr          , Yr          , Dd          , Zw          , Zw          , Dd          , Dd          , Dd          , Zw          , Yr          , _off^_usr   , _off^_usr   , _off^_usr   , _off^_usr   , _off^_usr   , _off^_usr   , _off^_usr   , _off^_usr   , _off^_usr   , _off^_usr   , _off^_usr   , _off^_usr   , _off^_usr   , _off^_usr   , _off^_usr   , _off^_usr   , _off^_usr   , _off^_usr   
Dd          , Dd          , Yr          , Zw          , Dd          , Zw          , Zw          , Yrh         , Zw          , Zw          , Dd          , Dd          , Zw          , Zw          , Zw          , Zw          , Dd          , Dd          , Zw          , Zw          , Dd          , Dd          , _off^_usr   , _off^_usr   , _off^_usr   , _off^_usr   , _off^_usr   , _off^_usr   , _off^_usr   , _off^_usr   , _off^_usr   , _off^_usr   , _off^_usr   , _off^_usr   , _off^_usr   , _off^_usr   , _off^_usr   , _off^_usr   , _off^_usr   , _off^_usr   , _off^_usr   , _off^_usr   
Dd          , Zw          , Zw          , Dd          , Dd          , Yr          , Yr          , Dd          , Dd          , Zw          , Zw          , Dd          , Yrh         , Zw          , Zw          , Dd^Do       , Dd          , Dd          , Dd          , Dd          , _off^_usr   , _off^_usr   , _off^_usr   , _off^_usr   , _off^_usr   , _off^_usr   , _off^_usr   , _off^_usr   , _off^_usr   , _off^_usr   , _off^_usr   , _off^_usr   , _off^_usr   , _off^_usr   , _off^_usr   , _off^_usr   , _off^_usr   , _off^_usr   , _off^_usr   , _off^_usr   , _off^_usr   , _off^_usr   
Dd^Dc       , Zw          , Yr          , Dd          , Dd          , Yr          , Zw          , Zw          , Dd          , Dd          , Zw          , Zw          , Yr          , Zw          , Yrh         , Yr          , Dd          , Dd          , _off^_usr   , _off^_usr   , _off^_usr   , _off^_usr   , _off^_usr   , _off^_usr   , _off^_usr   , _off^_usr   , _off^_usr   , _off^_usr   , _off^_usr   , _off^_usr   , _off^_usr   , _off^_usr   , _off^_usr   , _off^_usr   , _off^_usr   , _off^_usr   , _off^_usr   , _off^_usr   , _off^_usr   , _off^_usr   , _off^_usr   , _off^_usr   
Dd          , Dd          , Dd          , Yr          , Zw          , Yr          , Yr          , Dd          , Dd^Dc       , Dd          , Dd          , Yr          , Zw          , Zw          , Dd          , Yr          , _off^_usr   , _off^_usr   , _off^_usr   , _off^_usr   , _off^_usr   , _off^_usr   , _off^_usr   , _off^_usr   , _off^_usr   , _off^_usr   , _off^_usr   , _off^_usr   , _off^_usr   , _off^_usr   , _off^_usr   , _off^_usr   , _off^_usr   , _off^_usr   , _off^_usr   , _off^_usr   , _off^_usr   , _off^_usr   , _off^_usr   , _off^_usr   , _off^_usr   , _off^_usr   
Zw          , Dd^Do       , Yrh         , Zw          , Zw          , Zw          , Yr          , Dd          , Dd          , Dd          , Dd          , Zw          , Zw          , Zw          , _off^_usr   , _off^_usr   , _off^_usr   , _off^_usr   , _off^_usr   , _off^_usr   , _off^_usr   , _off^_usr   , _off^_usr   , _off^_usr   , _off^_usr   , _off^_usr   , _off^_usr   , _off^_usr   , _off^_usr   , _off^_usr   , _off^_usr   , _off^_usr   , _off^_usr   , _off^_usr   , _off^_usr   , _off^_usr   , _off^_usr   , _off^_usr   , _off^_usr   , _off^_usr   , _off^_usr   , _off^_usr   
Zw          , Zw          , Yr          , Yr          , Zw          , Zw          , Yrh         , Yrh         , Yrh         , Zw          , Zw          , Dd          , _off^_usr   , _off^_usr   , _off^_usr   , _off^_usr   , _off^_usr   , _off^_usr   , _off^_usr   , _off^_usr   , _off^_usr   , _off^_usr   , _off^_usr   , _off^_usr   , _off^_usr   , _off^_usr   , _off^_usr   , _off^_usr   , _off^_usr   , _off^_usr   , _off^_usr   , _off^_usr   , _off^_usr   , _off^_usr   , _off^_usr   , _off^_usr   , _off^_usr   , _off^_usr   , _off^_usr   , _off^_usr   , _off^_usr   , _off^_usr   
Zw          , Yr          , Yrh         , Yr          , Yr          , Zw          , Yrh         , Yrh         , Yrh         , Zw          , _off^_usr   , _off^_usr   , _off^_usr   , _off^_usr   , _off^_usr   , _off^_usr   , _off^_usr   , _off^_usr   , _off^_usr   , _off^_usr   , _off^_usr   , _off^_usr   , _off^_usr   , _off^_usr   , _off^_usr   , _off^_usr   , _off^_usr   , _off^_usr   , _off^_usr   , _off^_usr   , _off^_usr   , _off^_usr   , _off^_usr   , _off^_usr   , _off^_usr   , _off^_usr   , _off^_usr   , _off^_usr   , _off^_usr   , _off^_usr   , _off^_usr   , _off^_usr   
Zw          , Yr          , Yr          , Yr          , Yr          , Yrh         , Dd          , Dd          , _off^_usr   , _off^_usr   , _off^_usr   , _off^_usr   , _off^_usr   , _off^_usr   , _off^_usr   , _off^_usr   , _off^_usr   , _off^_usr   , _off^_usr   , _off^_usr   , _off^_usr   , _off^_usr   , _off^_usr   , _off^_usr   , _off^_usr   , _off^_usr   , _off^_usr   , _off^_usr   , _off^_usr   , _off^_usr   , _off^_usr   , _off^_usr   , _off^_usr   , _off^_usr   , _off^_usr   , _off^_usr   , _off^_usr   , _off^_usr   , _off^_usr   , _off^_usr   , _off^_usr   , _off^_usr   
Zw          , Zw          , Dd          , Dd          , Zw          , Zw          , _off^_usr   , _off^_usr   , _off^_usr   , _off^_usr   , _off^_usr   , _off^_usr   , _off^_usr   , _off^_usr   , _off^_usr   , _off^_usr   , _off^_usr   , _off^_usr   , _off^_usr   , _off^_usr   , _off^_usr   , _off^_usr   , _off^_usr   , _off^_usr   , _off^_usr   , _off^_usr   , _off^_usr   , _off^_usr   , _off^_usr   , _off^_usr   , _off^_usr   , _off^_usr   , _off^_usr   , _off^_usr   , _off^_usr   , _off^_usr   , _off^_usr   , _off^_usr   , _off^_usr   , _off^_usr   , _off^_usr   , _off^_usr   
