border_size=1
usage=map

Mm          , Mm          , Mm          , Mm          , Mm          , Mm          , Mm          , Mm          , Mm          , Hh          , Hh          , Hh          , Mm          , Mm          , Mm          , Hh          , Hh          , Gs          , Gs          , Gs          , Gs          , Gs          , Gs          , Gs          , Gs          , Gs          , Gs          , Gs          , Gs          , Gs          , Hd          , Hd          , Hd          , Hd          , Hd          , Hd          , Hd          , Hd          , Hd          , Hd          , Hd          , Hd          
Mm          , Mm          , Mm          , Mm          , Hh          , Mm          , Mm          , Mm          , Mm          , Mm          , Mm          , Hh          , Mm          , Mm          , Mm          , Hh          , Gs          , Gs          , Qxv         , Qxv         , Qxv         , Gs          , Ds          , Ds          , Gs          , Ds          , Gs          , Gs          , Gs          , Hd          , Hd          , Hd          , Gs          , Hd          , Gs          , Gs          , Gs          , Gs          , Gs          , Hd          , Ds          , Gs          
Mm          , Mm          , Hh          , Hh          , Hh          , Hh          , Mm          , Mm          , Mm          , Ce          , Mm          , Mm          , Mm          , Mm          , Hh          , Gs^Ft       , Gs          , Qxv         , Qxv         , Gs          , Gs          , Qxv         , Ds          , Gs          , Gs          , Gs          , Gs          , Qxv         , Gs          , Ds          , Ds          , Hd          , Qxv         , Qxv         , Qxv         , Gs          , Qxv         , Gs          , Ds          , Ds          , Gs          , Gs          
Hh          , Hh          , Hh          , Hh          , Gs          , Hh          , Hh          , Dd^Vdt      , Ce          , Ce          , Ce          , Ds          , Hh          , Mm          , Hh          , Ds          , Qxv         , Qxv         , Gs          , Qxv         , Ds          , Ds          , Hd          , Hd          , Gs          , Gs^Ft       , Gs          , Qxv         , Gs          , Ds          , Gs          , Ds          , Gs          , Gs          , Ds          , Qxv         , Ds          , Qxv         , Ds          , Gs          , Gs          , Gs          
Gs          , Hh          , Qxv         , Gs          , Gs^Ft       , Hh          , Hh          , Ce          , Ce          , 1 Ke        , Ce          , Ce          , Hh          , Mm          , Ds          , Hd          , Ds          , Qxv         , Qxv         , Qxv         , Gs          , Ds          , Gs          , Gs          , Gs          , Gs^Ft       , Qxv         , Qxv         , Ss          , Ss          , Ss          , Gs          , Ss          , Ss          , Ss          , Ds          , Gs          , Gs          , Ds          , Ds          , Ds          , Gs          
Qxv         , Qxv         , Qxv         , Gs          , Gs^Ft       , Gs          , Gs          , Ds          , Ce          , Ce          , Rd          , Dd^Vdt      , Gs          , Ds          , Ds          , Ds          , Qxv         , Gs          , Gs          , Gs          , Qxv         , Gs          , Gs          , Gs          , Gs^Ft       , Gs^Ft       , Gs^Vht      , Gs          , Chs         , Ch          , Ss          , Hh          , Ss          , Ss          , Ss          , Gs          , Gs          , Qxv         , Gs          , Gs          , Ds          , Gs          
Gs          , Qxv         , Gs          , Gs          , Gs          , Gs          , Hd          , Hh          , Ds          , Dd^Vdt      , Gs          , Rd          , Rd          , Gs          , Rd          , Gs          , Gs          , Qxv         , Qxv         , Gs          , Gs          , Qxv         , Gs          , Gs^Ft       , Gs^Ft       , Gs^Ft       , Ds          , Ss          , Chs         , 6 Kh        , Chs         , Ss          , Ss^Vm       , Ss          , Ss          , Ss          , Gs          , Qxv         , Qxv         , Gs          , Gs          , Gs          
Ds          , Ds          , Ds          , Ds          , Qxv         , Gs          , Hd          , Ds          , Qxv         , Ds          , Gs          , Ds          , Ds          , Rd          , Gs          , Rd          , Rd          , Gs          , Gs          , Qxv         , Ds          , Qxv         , Ds          , Gs^Ft       , Ds          , Gs^Ft       , Ds          , Ss          , Ch          , Chs         , Chs         , Ss          , Ss          , Ss          , Ss          , Ss^Vhs      , Ds          , Gs          , Qxv         , Gs          , Gs          , Gs          
Ds          , Ds          , Ds          , Qxv         , Qxv         , Gs          , Gs          , Qxv         , Gs          , Qxv         , Qxv         , Ds          , Ds          , Gs          , Hh          , Hh          , Hh          , Rd          , Rd          , Gs          , Ds          , Qxv         , Qxv         , Gs          , Gs          , Gs^Ft       , Gs          , Rd          , Ss          , Chs         , Ch          , Ss          , Ss          , Ss          , Gs^Ft       , Ds          , Ds          , Ds          , Ds          , Qxv         , Gs          , Gs          
Gs          , Gs^Vht      , Gs          , Gs          , Qxv         , Gs          , Gs          , Hh          , Qxv         , Qxv         , Qxv         , Qxv         , Gs          , Gs          , Ds          , Ds          , Hh          , Ds          , Ds          , Rd          , Rd          , Gs          , Gs          , Gs          , Gs          , Gs          , Gs          , Rd          , Gs          , Ss          , Gs          , Ss          , Gs^Ft       , Ss          , Gs^Ft       , Ds          , Hh          , Ds          , Gs          , Gs          , Gs          , Ww          
Qxv         , Qxv         , Qxv         , Qxv         , Qxv         , Hh          , Ds          , Ds          , Ds          , Gs          , Qxv         , Gs          , Qxv         , Qxv         , Qxv         , Ds          , Hh          , Ds          , Gs          , Gs          , Rd          , Rd          , Gs          , Gs          , Ds          , Gs          , Rd          , Rd          , Qxv         , Gs^Vht      , Ds          , Ds          , Gs          , Hh          , Gs^Ft       , Hh          , Hh          , Gs          , Gs          , Gs          , Ww          , Ww          
Qxv         , Qxv         , Qxv         , Qxv         , Qxv         , Ds          , Hh          , Qxv         , Qxv         , Qxv         , Ds          , Gs          , Qxv         , Qxv         , Qxv         , Ds          , Qxv         , Gs          , Gs^Ft       , Gs^Ft       , Rd          , Rd          , Ds          , Ds          , Gs          , Gs          , Rd          , Gs          , Qxv         , Ds          , Gs          , Ds          , Gs^Ft       , Gs          , Gs^Ft       , Gs          , Gs          , Gs          , Gs          , Gs          , Ww          , Wo          
Qxv         , Qxv         , Qxv         , Qxv         , Hh          , Hh          , Hh          , Qxv         , Hh          , Hh          , Ds          , Ds          , Hh          , Ds          , Qxv         , Ds          , Qxv         , Gs          , Ds          , Gs          , Ds          , Rd          , Rd          , Ds          , Gs          , Gs          , Rd          , Gs          , Gs          , Qxv         , Gs          , Gs          , Gs^Ft       , Gs^Ft       , Gs          , Gs          , Gs          , Gs          , Ww          , Ww          , Wo          , Wo          
Ds          , Gs          , Ds          , Gs          , Gs          , Gs          , Gs          , Qxv         , Hh          , Hh          , Hh          , Ds          , Gs          , Ds          , Ds          , Qxv         , Qxv         , Gs          , Qxv         , Ds          , Ds          , Rd          , Rd          , Rd          , Rd          , Rd          , Rd          , Gs          , Gs          , Gs          , Gs          , Gs          , Ww          , Ww          , Ww          , Ww          , Ww          , Ww          , Wo          , Wo          , Ww          , Ww          
Ds          , Ds          , Ds          , Gs^Vht      , Ds          , Gs          , Gs          , Gs          , Ww          , Gs          , Ww          , Gs          , Ww          , Gs          , Ww          , Ds          , Gs          , Qxv         , Ds          , Gs          , Ds          , Ds          , Ww^Bw|      , Rd          , Ww          , Rd          , Ww^Bw|      , Gs          , Ww          , Ww          , Ww          , Ww          , Wo          , Wo          , Wo          , Wo          , Ww          , Ww          , Ww          , Ww          , Gs          , Gs          
Ds          , Ds          , Wwf         , Gs          , Wwf         , Wwf         , Ww          , Ww          , Wo          , Ww          , Wo          , Ww          , Wo          , Ww          , Wo          , Ww          , Ww          , Gs          , Gs          , Gs          , Ww          , Ww          , Wo^Bw|      , Ww          , Wo          , Ww          , Wo^Bw|      , Ww          , Wo          , Ww          , Wo          , Wo          , Ww          , Ww          , Ww          , Ww          , Gs          , Ww          , Gs          , Gs          , Ds          , Ds          
Ww          , Ww          , Ww          , Wwf         , Wwf         , Wwf         , Ww          , Wo          , Wo          , Wo          , Ww          , Wo          , Ww          , Ww          , Ww          , Wo          , Wo          , Ww          , Ww          , Ww          , Wo          , Wo          , Wo^Bw|      , Wo          , Ww          , Wo          , Wo^Bw|      , Ww          , Ww          , Ww          , Ww          , Ww          , Gs          , Gs          , Gs          , Gs          , Gs          , Gs          , Gs          , Gs          , Ds          , Ds          
Wo          , Wo          , Ww          , Wwf         , Wwf         , Ww          , Ww          , Ww          , Ww          , Ww          , Yr          , Ww          , Yrh         , Ww          , Hh          , Ww          , Ww          , Ww          , Ww          , Ww          , Ww          , Ww          , Gs          , Ww          , Rd          , Ww          , Gs          , Gs          , Hh          , Hh          , Hh          , Hh          , Hh          , Hh          , Qxv         , Gs          , Gs          , Qxv         , Qxv         , Gs          , Ds          , Ds          
Ww          , Ww          , Hh          , Wwf         , Yr          , Wwf         , Wwf         , Gs^Vht      , Wwf         , Yrh         , Yr          , Yr          , Yrh         , Hh          , Hh          , Hh          , Hh          , Ds          , Ds          , Gs^Ft       , Gs^Ft       , Gs^Ft       , Gs          , Rd          , Gs          , Gs          , Gs          , Gs          , Qxv         , Ds          , Ds          , Ds          , Hh          , Hh          , Qxv         , Qxv         , Qxv         , Qxv         , Qxv         , Ds          , Ds          , Gs          
Gs          , Yr          , Gs^Ft       , Wwf         , Wwf         , Chw         , Chr         , Chw         , Chr         , Ww          , Rd          , Yr          , Yr          , Gs^Ft       , Yrh         , Gs^Ft       , Gs          , Ds          , Qxv         , Qxv         , Qxv         , Gs^Ft       , Rd          , Rd          , Gs          , Gs          , Yr          , Qxv         , Gs          , Qxv         , Qxv         , Hh^Vhh      , Hh          , Qxv         , Qxv         , Qxv         , Qxv         , Qxv         , Hh          , Qxv         , Gs          , Gs          
Yr          , Yr          , Yrh         , Gs^Ft       , Wwf         , Chr         , 5 Khw       , Chw         , Chr         , Wwf         , Gs^Vht      , Rd          , Rd          , Rd          , Rd          , Rd          , Rd          , Rd          , Rd          , Rd          , Rd          , Rd          , Rd          , Gs          , Yr          , Gs          , Yr          , Qxv         , Ds          , Ds          , Ds          , Qxv         , Ds          , Qxv         , Gs          , Qxv         , Ds          , Hh          , Ds          , Qxv         , Gs          , Gs          
Yr          , Yr          , Yr          , Gs          , Yrh         , Chw         , Chw         , Wwf         , Chr         , Wwf         , Yr          , Yr          , Yr          , Gs^Ft       , Yrh         , Gs          , Gs          , Ds          , Ds          , Hh          , Gs          , Gs          , Rd          , Yr          , Yr          , Yr          , Yr          , Gs          , Gs^Ft       , Ds          , Ds          , Ss          , Ds          , Qxv         , Qxv         , Ds          , Ds          , Ds          , Ds          , Qxv         , Gs          , Gs          
Ds          , Yr          , Gs^Ft       , Yrh         , Wwf         , Wwf         , Wwf         , Yrh         , Yrh         , Yrh         , Gs^Ft       , Gs^Ft       , Yrh         , Yr          , Gs          , Hh^Vhh      , Ds          , Ds          , Hh          , Qxv         , Qxv         , Gs^Ft       , Gg^Vh       , Rd          , Rd          , Yr          , Gs^Ft       , Qxv         , Qxv         , Ds          , Ds          , Ss          , Ss          , Ds          , Gs          , Hh          , Gs          , Ds          , Gs          , Ds          , Gs          , Gs          
Ds          , Yr          , Yr          , Yrh         , Yr          , Yrh         , Yr          , Gs^Vht      , Yr          , Yr          , Yr          , Yr          , Yr          , Yr          , Gs^Ft       , Ds          , Ds          , Hh          , Gs^Ft       , Hh          , Qxv         , Yr          , Yrh         , Ch          , Rd          , Yr          , Yr          , Gs^Ft       , Yr          , Ds          , Ss          , Ss          , Ss          , Ss          , Rd          , Gs          , Hh          , Gs^Ft       , Ds          , Ds          , Ds          , Gs          
Yr          , Ds          , Yr          , Yr          , Yrh         , Yr          , Yr          , Yr          , Gs^Ft       , Gs^Ft       , Yr          , Gs^Ft       , Gs^Ft       , Gs^Ft       , Gs^Ft       , Gs^Ft       , Hh          , Hh          , Gs^Ft       , Gs^Ft       , Yrh         , Ch          , Chr         , Chr         , Rd          , Yr          , Gg^Vh       , Yr          , Yr          , Yr          , Ss          , Ss          , Ss          , Ss          , Ds          , Rd          , Rd          , Hh          , Ds          , Ds          , Ss          , Ds          
Yr          , Yr          , Yrh         , Yr          , Qxv         , Qxv         , Qxv         , Yrh         , Yr          , Yr          , Ds          , Gs          , Ds          , Hh          , Qxv         , Hh          , Gs^Ft       , Hh          , Hh          , Ss          , Ss          , Yrh         , Chr         , 4 Khr       , Chr         , Rd          , Yrh         , Yr          , Ss          , Ss          , Gs^Ft       , Ss          , Ss          , Rd          , Rd          , Ds          , Hh          , Hh          , Ds          , Ds          , Ss          , Ds          
Gs          , Yr          , Gs          , Yr          , Qxv         , Gs          , Qxv         , Qxv         , Qxv         , Yr          , Ds          , Ds          , Hd          , Hd          , Qxv         , Gs^Ft       , Gs^Ft       , Gs^Ft       , Qxv         , Gs          , Ss          , Yrh         , Chs         , Chr         , Chr         , Rd          , Yr          , Yr          , Gs          , Ds          , Gs^Ft       , Ss          , Ss          , Ss          , Ss          , Ds          , Ds          , Ds          , Gs          , Ss          , Ds          , Gs          
Gs          , Gs          , Gs^Ft       , Ds          , Ds          , Ds          , Qxv         , Qxv         , Qxv         , Qxv         , Gs          , Ds          , Hd          , Hd          , Qxv         , Gs^Ft       , Gs^Ft       , Hh          , Qxv         , Gs          , Gs          , Ss          , Chs         , Chs         , Ch          , Yr          , Yr          , Yrh         , Gs          , Ds          , Rd          , Rd          , Ss          , Ss          , Ss          , Gs^Ft       , Ds          , Rd          , Gs^Ft       , Gs          , Gs          , Gs          
Ds          , Gs          , Ds          , Gs          , Hd          , Ds          , Qxv         , Qxv         , Qxv         , Gs          , Gs          , Ds          , Ds          , Hd          , Hd          , Qxv         , Qxv         , Gs^Vht      , Gs^Ft       , Qxv         , Qxv         , Ds          , Ss          , Ss          , Ss          , Yr          , Yr          , Gs          , Qxv         , Gs^Ft       , Rd          , Ds          , Ss          , Ss          , Ss          , Ss          , Ss          , Ds          , Gs          , Gs          , Gs^Ft       , Gs^Ft       
Gs          , Ds          , Ds          , Ds          , Hd          , Ds          , Qxv         , Qxv         , Qxv         , Ds          , Ds          , Ds          , Qxv         , Ds          , Hd          , Hd          , Qxv         , Gs          , Gs^Ft       , Gs          , Ds          , Ds          , Gg^Vh       , Ss          , Rd          , Yrh         , Hh          , Hh          , Gs          , Qxv         , Gs          , Ds          , Ds          , Ss          , Ss          , Ss          , Ds          , Ds          , Gs^Ft       , Gs          , Gs^Ft       , Ds          
Hd          , Hd          , Hd          , Ds          , Ds          , Qxv         , Gs          , Qxv         , Qxv         , Qxv         , Qxv         , Gs          , Qxv         , Qxv         , Gs          , Hd          , Ds          , Qxv         , Gs          , Gs^Ft       , Yr          , Yr          , Yr          , Yr          , Rd          , Gs          , Hh          , Hh          , Hh          , Hh          , Ss          , Ds          , Ds          , Ds          , Ss          , Gs^Ft       , Ds          , Rd          , Ds          , Ds          , Ss          , Ds          
Md          , Hd          , Hd          , Ds          , Ds          , Ds          , Hh          , Qxv         , Gs          , Gs          , Qxv         , Gs          , Qxv         , Gs          , Gs          , Hd          , Ds          , Qxv         , Qxv         , Qxv         , Gs          , Yr          , Yr          , Yr          , Rd          , Gs          , Gs          , Ss          , Ss          , Ss          , Ss          , Gs          , Gs          , Hh          , Ds          , Ds          , Qxv         , Ds          , Gs^Ft       , Ss          , Ss          , Ds          
Md          , Md          , Hd          , Hd          , Qxv         , Ds          , Gs          , Qxv         , Gs          , Gs          , Gs          , Gs          , Hh          , Qxv         , Qxv         , Hd          , Ds          , Ds          , Gs          , Hh          , Yr          , Gs          , Gs          , Rd          , Gs          , Gs          , Gs^Ft       , Yr          , Yr          , Ss          , Gs          , Gs          , Qxv         , Gs          , Qxv         , Qxv         , Gs          , Qxv         , Gs          , Ss          , Ss          , Gs          
Md          , Md          , Md          , Hd          , Hd          , Qxv         , Qxv         , Qxv         , Qxv         , Qxv         , Ds          , Gs^Ft       , Hh          , Qxv         , Hd          , Hd          , Ds          , Hd          , Hh          , Hh          , Hh          , Hh          , Ss          , Rd          , Gs          , Gs          , Qxv         , Yr          , Hd          , Hd          , Qxv         , Qxv         , Gs          , Qxv         , Gs          , Gs          , Gs          , Qxv         , Gs          , Ss          , Ds          , Hd          
Hd          , Md          , Md          , Hd          , Hd          , Qxv         , Gs          , Gs          , Ds          , Ds          , Ds          , Hh          , Hh          , Hh          , Hd          , Hd          , Hd          , Hd          , Dd^Vda      , Chr         , Chr         , Chr         , Gs          , Rd          , Gs          , Hh          , Hh          , Hh          , Hd          , Hd          , Dd^Vda      , Gs          , Qxv         , Qxv         , Qxv         , Qxv         , Qxv         , Ds          , Ds          , Ds          , Hh          , Hd          
Hd          , Md          , Md          , Md          , Hd          , Hd          , Gs          , Gs          , Ds          , Ds          , Ds          , Hh          , Hd          , Hd          , Md          , Md          , Hd          , Hd          , Hd          , Chr         , Chr         , 3 Khr       , Chr         , Rd          , Ds          , Ds          , Yr          , Yr          , Chr         , Chr         , Chr         , Hd          , Hh          , Hh          , Qxv         , Qxv         , Hh          , Hh          , Hd          , Hh          , Hd          , Hd          
Hd          , Hd          , Md          , Md          , Md          , Hd          , Hd          , Hd          , Ds          , Ds          , Hd          , Hh          , Hd          , Hd          , Md          , Md^Xm       , Md          , Md          , Hd          , Dd^Vdt      , Chr         , Chr         , Ds          , Rd          , Ds          , Dd          , Rd          , Chr         , Chr         , 2 Khr       , Chr         , Dd^Vdt      , Hd          , Hh          , Hd          , Hh          , Hd          , Hd          , Hd          , Hd          , Hd          , Hd          
Hd          , Hd          , Hd          , Md          , Md          , Hd          , Hd          , Hd          , Hd          , Hd          , Hd          , Hd          , Md          , Md          , Md^Xm       , Md^Xm       , Md          , Md          , Hd          , Hd          , Hd          , Dd^Vda      , Ds          , Rd          , Rd          , Rd          , Dd          , Gs          , Hd          , Chr         , Chr         , Hd          , Hd          , Hd          , Hd          , Hd          , Hd          , Hd          , Md          , Md          , Md^Xm       , Hd          
Md^Xm       , Hd          , Hd          , Md          , Md          , Md          , Md          , Md          , Md          , Hd          , Md          , Hd          , Md          , Md^Xm       , Md^Xm       , Md^Xm       , Md^Xm       , Md          , Hd          , Hd          , Ds          , Dd          , Dd          , Rd          , Ds          , Dd          , Hd          , Hd          , Md          , Dd^Vda      , Md          , Md          , Md          , Md          , Md          , Md          , Md^Xm       , Md^Xm       , Md^Xm       , Md^Xm       , Md^Xm       , Md^Xm       
Md^Xm       , Md^Xm       , Md^Xm       , Md          , Md^Xm       , Md          , Md^Xm       , Md          , Md^Xm       , Md          , Md^Xm       , Md          , Md          , Md          , Md^Xm       , Md^Xm       , Md^Xm       , Md^Xm       , Md          , Hd          , Hd          , Dd          , Dd          , Rd          , Rd          , Ds          , Dd          , Hd          , Md          , Md          , Md          , Md          , Md          , Md^Xm       , Md^Xm       , Md          , Md^Xm       , Md^Xm       , Md^Xm       , Md^Xm       , Md^Xm       , Md^Xm       
Md^Xm       , Md^Xm       , Md^Xm       , Md^Xm       , Md^Xm       , Md^Xm       , Md^Xm       , Md^Xm       , Md^Xm       , Md^Xm       , Md^Xm       , Md^Xm       , Md^Xm       , Md          , Md^Xm       , Md^Xm       , Md^Xm       , Md          , Md          , Md          , Md          , Hd          , Hd          , Ds          , Dd          , Rd          , Dd          , Hd          , Md          , Md          , Md^Xm       , Md          , Md^Xm       , Md^Xm       , Md^Xm       , Md^Xm       , Md^Xm       , Md^Xm       , Md^Xm       , Md^Xm       , Md^Xm       , Md^Xm       
Md^Xm       , Md^Xm       , Md^Xm       , Md^Xm       , Md^Xm       , Md^Xm       , Md^Xm       , Md^Xm       , Md^Xm       , Md^Xm       , Md^Xm       , Md^Xm       , Md^Xm       , Md^Xm       , Md^Xm       , Md^Xm       , Md^Xm       , Md^Xm       , Md^Xm       , Md^Xm       , Md^Xm       , Hd          , Ds          , Ds          , Hd          , Rd          , Dd          , Hd          , Md^Xm       , Md^Xm       , Md^Xm       , Md^Xm       , Md^Xm       , Md^Xm       , Md^Xm       , Md^Xm       , Md^Xm       , Md^Xm       , Md^Xm       , Md^Xm       , Md^Xm       , Md^Xm       
Md^Xm       , Md^Xm       , Md^Xm       , Md^Xm       , Md^Xm       , Md^Xm       , Md^Xm       , Md^Xm       , Md^Xm       , Md^Xm       , Md^Xm       , Md^Xm       , Md^Xm       , Md^Xm       , Md^Xm       , Md^Xm       , Md^Xm       , Md^Xm       , Md^Xm       , Md^Xm       , Md^Xm       , Hd          , Dd          , Dd          , Dd          , Rd          , Dd          , Hd          , Md^Xm       , Md^Xm       , Md^Xm       , Md^Xm       , Md^Xm       , Md^Xm       , Md^Xm       , Md^Xm       , Md^Xm       , Md^Xm       , Md^Xm       , Md^Xm       , Md^Xm       , Md^Xm       
