border_size=1
usage=map

Xu          , Xu          , Xu          , Xu          , Xu          , Xu          , Xu          , Xu          , Xu          , Rr          , Rr          , Rr          , Yr          , Yr          , Xu          , Xu          , Xu          , Xu          , Xu          , Xu          , Xu          , Xu          
Qxs         , Xu          , Xu          , Xu          , Xu          , Xu          , Xu          , Xu          , Xu          , Yr          , Rr          , Yr          , Yl          , Yr          , Xu          , Xu          , Xu          , Xu          , Xu          , Xu          , Xu          , Xu          
Qxs         , Qxs         , Qxs         , Xu          , Xu          , Xu          , Xu          , Xu          , Xu          , Yr          , Yrh         , 1 Rr        , Yl          , Yrh         , Xu          , Xu          , Xu          , Xu          , Xu          , Xu          , Qxs         , Qxs         
Qxs         , Qxs         , Qxs         , Qxs         , Qxs         , Xu          , Xu          , Xu          , Xu          , Rr          , Yr          , Rr          , Yr          , Yl          , Xu          , Xu          , Xu          , Xu          , Qxs         , Qxs         , Qxs         , Qxs         
Qxs         , Qxs         , Qxs         , Qxs         , Qxs         , Qxs         , Qxs         , Xu          , Xu          , Yr          , Yr          , Yl          , Yr          , Yrh         , Xu          , Xu          , Qxs         , Qxs         , Qxs         , Qxs         , Qxs         , Qxs         
Qxs         , Qxs         , Qxs         , Qxs         , Qxs         , Qxs         , Qxs         , Qxs         , Qxs         , Yl          , Yl          , Yrh         , Rr          , Rr          , Qxs         , Qxs         , Qxs         , Qxs         , Qxs         , Qxs         , Qxs         , Qxs         
Qxs         , Qxs         , Qxs         , Qxs         , Qxs         , Qxs         , Qxs         , Qxs         , Qxs         , Yrh         , Yr          , Rr          , Yl          , Yrh         , Qxs         , Qxs         , Qxs         , Qxs         , Qxs         , Qxs         , Qxs         , Qxs         
Qxs         , Qxs         , Qxs         , Qxs         , Qxs         , Qxs         , Qxs         , Qxs         , Qxs         , Rr          , Yr          , Yrh         , Yr          , Yr          , Qxs         , Qxs         , Qxs         , Qxs         , Qxs         , Qxs         , Qxs         , Qxs         
Qxs         , Qxs         , Qxs         , Qxs         , Qxs         , Qxs         , Qxs         , Qxs         , Qxs         , Yl          , Yrh         , Rr          , Yr          , Yrh         , Qxs         , Qxs         , Qxs         , Qxs         , Qxs         , Qxs         , Qxs         , Qxs         
Qxs         , Qxs         , Qxs         , Qxs         , Qxs         , Qxs         , Qxs         , Qxs         , Qxs         , Rr          , Yl          , Rr          , Rr          , Yr          , Qxs         , Qxs         , Qxs         , Qxs         , Qxs         , Qxs         , Qxs         , Qxs         
Qxs         , Qxs         , Qxs         , Qxs         , Qxs         , Qxs         , Qxs         , Qxs         , Qxs         , Yl          , Rr          , Rr          , Yl          , Rr          , Qxs         , Qxs         , Qxs         , Qxs         , Qxs         , Qxs         , Qxs         , Qxs         
Qxs         , Qxs         , Qxs         , Qxs         , Qxs         , Qxs         , Qxs         , Qxs         , Qxs         , Cud         , Yl          , Rr          , Ryd         , Yl          , Qxs         , Qxs         , Qxs         , Qxs         , Qxs         , Qxs         , Qxs         , Qxs         
Qxs         , Qxs         , Qxs         , Qxs         , Qxs         , Qxs         , Qxs         , Qxs         , Qxs         , Yl          , Ryd         , Rr          , Yl          , Rr          , Qxs         , Qxs         , Qxs         , Qxs         , Qxs         , Qxs         , Qxs         , Qxs         
Qxs         , Qxs         , Qxs         , Qxs         , Qxs         , Qxs         , Qxs         , Qxs         , Qxs         , Rr          , Yl          , Ryd         , Rr          , Yl          , Qxs         , Qxs         , Qxs         , Qxs         , Qxs         , Qxs         , Qxs         , Qxs         
Qxs         , Qxs         , Qxs         , Qxs         , Qxs         , Qxs         , Qxs         , Qxs         , Qxs         , Yl          , Rr          , Rr          , Yl          , Ryd         , Qxs         , Qxs         , Qxs         , Qxs         , Qxs         , Qxs         , Qxs         , Qxs         
Qxs         , Qxs         , Qxs         , Qxs         , Qxs         , Qxs         , Qxs         , Qxs         , Qxs         , Cud         , Yl          , Rr          , Ryd         , Yl          , Qxs         , Qxs         , Qxs         , Qxs         , Qxs         , Qxs         , Qxs         , Qxs         
Qxs         , Qxs         , Qxs         , Qxs         , Qxs         , Qxs         , Qxs         , Qxs         , Qxs         , Yl          , Ryd         , Rr          , Rr          , Ryd         , Qxs         , Qxs         , Qxs         , Qxs         , Qxs         , Qxs         , Qxs         , Qxs         
Qxs         , Qxs         , Qxs         , Qxs         , Qxs         , Qxs         , Qxs         , Qxs         , Qxs         , Ryd         , Rr          , Ryd         , Ryd         , Cud         , Qxs         , Qxs         , Qxs         , Qxs         , Qxs         , Qxs         , Qxs         , Qxs         
Qxs         , Qxs         , Qxs         , Qxs         , Qxs         , Qxs         , Qxs         , Qxs         , Qxs         , Rr          , Ryd         , Ryd         , Rr          , Rr          , Qxs         , Qxs         , Qxs         , Qxs         , Qxs         , Qxs         , Qxs         , Qxs         
Qxs         , Qxs         , Qxs         , Qxs         , Qxs         , Qxs         , Qxs         , Qxs         , Qxs         , Ryd         , Rr          , Ryd         , Rr          , Ryd         , Qxs         , Qxs         , Qxs         , Qxs         , Qxs         , Qxs         , Qxs         , Qxs         
Qxs         , Qxs         , Qxs         , Qxs         , Qxs         , Qxs         , Qxs         , Qxs         , Qxs         , Ryd         , Ryd         , Ryd         , Ryd         , Rr          , Qxs         , Qxs         , Qxs         , Qxs         , Qxs         , Qxs         , Qxs         , Qxs         
Qxs         , Qxs         , Qxs         , Qxs         , Qxs         , Qxs         , Qxs         , Qxs         , Qxs         , Rr          , Yl          , Rr          , Yr          , Ryd         , Qxs         , Qxs         , Qxs         , Qxs         , Qxs         , Qxs         , Qxs         , Qxs         
Qxs         , Qxs         , Qxs         , Qxs         , Qxs         , Qxs         , Qxs         , Qxs         , Qxs         , Ryd         , Yl          , Yl          , Ryd         , Ryd         , Qxs         , Qxs         , Qxs         , Qxs         , Qxs         , Qxs         , Qxs         , Qxs         
Qxs         , Qxs         , Qxs         , Qxs         , Qxs         , Qxs         , Qxs         , Qxs         , Qxs         , Yr          , Ryd         , Ryd         , Ryd         , Yl          , Qxs         , Qxs         , Qxs         , Qxs         , Qxs         , Qxs         , Qxs         , Qxs         
Qxs         , Qxs         , Qxs         , Qxs         , Qxs         , Qxs         , Qxs         , Qxs         , Qxs         , Yr          , Yl          , Yr          , Ryd         , Yl          , Qxs         , Qxs         , Qxs         , Qxs         , Qxs         , Qxs         , Qxs         , Qxs         
Qxs         , Qxs         , Qxs         , Qxs         , Qxs         , Qxs         , Qxs         , Qxs         , Qxs         , Yr          , Yl          , Ryd         , Yr          , Cud         , Qxs         , Qxs         , Qxs         , Qxs         , Qxs         , Qxs         , Qxs         , Qxs         
Qxs         , Qxs         , Qxs         , Qxs         , Qxs         , Qxs         , Qxs         , Qxs         , Qxs         , Ryd         , Yr          , Yl          , Yl          , Yl          , Qxs         , Qxs         , Qxs         , Qxs         , Qxs         , Qxs         , Qxs         , Qxs         
Qxs         , Qxs         , Qxs         , Qxs         , Qxs         , Qxs         , Qxs         , Qxs         , Qxs         , Yl          , Yl          , Ryd         , Ryd         , Yl          , Qxs         , Qxs         , Qxs         , Qxs         , Qxs         , Qxs         , Qxs         , Qxs         
Qxs         , Qxs         , Qxs         , Qxs         , Qxs         , Qxs         , Qxs         , Qxs         , Qxs         , Ryd         , Ryd         , Ryd         , Ryd         , Yl          , Qxs         , Qxs         , Qxs         , Qxs         , Qxs         , Qxs         , Qxs         , Qxs         
Qxs         , Qxs         , Qxs         , Qxs         , Qxs         , Qxs         , Qxs         , Qxs         , Qxs         , Ryd         , Yl          , Yl          , Ryd         , Yl          , Qxs         , Qxs         , Qxs         , Qxs         , Qxs         , Qxs         , Qxs         , Qxs         
Qxs         , Qxs         , Qxs         , Qxs         , Qxs         , Qxs         , Qxs         , Qxs         , Qxs         , Ryd         , Yl          , Ryd         , Yl          , Ryd         , Qxs         , Qxs         , Qxs         , Qxs         , Qxs         , Qxs         , Qxs         , Qxs         
Qxs         , Qxs         , Qxs         , Qxs         , Qxs         , Qxs         , Qxs         , Qxs         , Qxs         , Yl          , Yl          , Yl          , Yl          , Ryd         , Qxs         , Qxs         , Qxs         , Qxs         , Qxs         , Qxs         , Qxs         , Qxs         
Qxs         , Qxs         , Qxs         , Qxs         , Qxs         , Qxs         , Qxs         , Qxs         , Qxs         , Ryd         , Yl          , Yl          , Ryd         , Ryd         , Qxs         , Qxs         , Qxs         , Qxs         , Qxs         , Qxs         , Qxs         , Qxs         
Qxs         , Qxs         , Qxs         , Qxs         , Qxs         , Qxs         , Qxs         , Qxs         , Qxs         , Yl          , Cud         , Ryd         , Yl          , Yl          , Qxs         , Qxs         , Qxs         , Qxs         , Qxs         , Qxs         , Qxs         , Qxs         
Qxs         , Qxs         , Qxs         , Qxs         , Qxs         , Qxs         , Qxs         , Qxs         , Qxs         , Ryd         , Yl          , Ryd         , Yl          , Yl          , Qxs         , Qxs         , Qxs         , Qxs         , Qxs         , Qxs         , Qxs         , Qxs         
Qxs         , Qxs         , Qxs         , Qxs         , Qxs         , Qxs         , Qxs         , Qxs         , Qxs         , Yl          , Ryd         , Ryd         , Ryd         , Cud         , Qxs         , Qxs         , Qxs         , Qxs         , Qxs         , Qxs         , Qxs         , Qxs         
Qxs         , Qxs         , Qxs         , Qxs         , Qxs         , Qxs         , Qxs         , Qxs         , Qxs         , Yl          , Ryd         , Zw          , Zw          , Yl          , Qxs         , Qxs         , Qxs         , Qxs         , Qxs         , Qxs         , Qxs         , Qxs         
Qxs         , Qxs         , Qxs         , Qxs         , Qxs         , Qxs         , Qxs         , Qxs         , Qxs         , Ryd         , Yl          , Yl          , Yl          , Ryd         , Qxs         , Qxs         , Qxs         , Qxs         , Qxs         , Qxs         , Qxs         , Qxs         
Qxs         , Qxs         , Qxs         , Qxs         , Qxs         , Qxs         , Qxs         , Qxs         , Qxs         , Yl          , Yl          , Ryd         , Ryd         , Ryd         , Qxs         , Qxs         , Qxs         , Qxs         , Qxs         , Qxs         , Qxs         , Qxs         
Qxs         , Qxs         , Qxs         , Qxs         , Qxs         , Qxs         , Qxs         , Qxs         , Qxs         , Ryd         , Yl          , Yl          , Ryd         , Ryd         , Qxs         , Qxs         , Qxs         , Qxs         , Qxs         , Qxs         , Qxs         , Qxs         
Qxs         , Qxs         , Qxs         , Qxs         , Qxs         , Qxs         , Qxs         , Qxs         , Qxs         , Yl          , Ryd         , Zw          , Yl          , Zw          , Qxs         , Qxs         , Qxs         , Qxs         , Qxs         , Qxs         , Qxs         , Qxs         
Qxs         , Qxs         , Qxs         , Qxs         , Qxs         , Qxs         , Qxs         , Qxs         , Qxs         , Yl          , Yl          , Zw          , Yl          , Ryd         , Qxs         , Qxs         , Qxs         , Qxs         , Qxs         , Qxs         , Qxs         , Qxs         
Qxs         , Qxs         , Qxs         , Qxs         , Qxs         , Qxs         , Qxs         , Qxs         , Qxs         , Cud         , Yl          , Zw          , Cud         , Yl          , Qxs         , Qxs         , Qxs         , Qxs         , Qxs         , Qxs         , Qxs         , Qxs         
Qxs         , Qxs         , Qxs         , Qxs         , Qxs         , Qxs         , Qxs         , Qxs         , Qxs         , Ryd         , Cud         , Zw          , Yl          , Yl          , Qxs         , Qxs         , Qxs         , Qxs         , Qxs         , Qxs         , Qxs         , Qxs         
Qxs         , Qxs         , Qxs         , Qxs         , Qxs         , Qxs         , Qxs         , Qxs         , Qxs         , Yl          , Yl          , Zw          , Yl          , Cud         , Qxs         , Qxs         , Qxs         , Qxs         , Qxs         , Qxs         , Qxs         , Qxs         
Qxs         , Qxs         , Qxs         , Qxs         , Qxs         , Qxs         , Qxs         , Qxs         , Qxs         , Zw          , Zw          , Yl          , Yl          , Yl          , Qxs         , Qxs         , Qxs         , Qxs         , Qxs         , Qxs         , Qxs         , Qxs         
Qxs         , Qxs         , Qxs         , Qxs         , Qxs         , Qxs         , Qxs         , Qxs         , Qxs         , Yl          , Ryd         , Zw          , Zw          , Ryd         , Qxs         , Qxs         , Qxs         , Qxs         , Qxs         , Qxs         , Qxs         , Qxs         
Qxs         , Qxs         , Qxs         , Qxs         , Qxs         , Qxs         , Qxs         , Qxs         , Qxs         , Yl          , Yl          , Ryd         , Yl          , Zw          , Qxs         , Qxs         , Qxs         , Qxs         , Qxs         , Qxs         , Qxs         , Qxs         
Qxs         , Qxs         , Qxs         , Qxs         , Qxs         , Qxs         , Qxs         , Qxs         , Qxs         , Ryd         , Yl          , Ryd         , Yl          , Ryd         , Qxs         , Qxs         , Qxs         , Qxs         , Qxs         , Qxs         , Qxs         , Qxs         
Qxs         , Qxs         , Qxs         , Qxs         , Qxs         , Qxs         , Qxs         , Qxs         , Qxs         , Yl          , Zw          , Yl          , Ryd         , Yl          , Qxs         , Qxs         , Qxs         , Qxs         , Qxs         , Qxs         , Qxs         , Qxs         
Qxs         , Qxs         , Qxs         , Qxs         , Qxs         , Qxs         , Qxs         , Qxs         , Qxs         , Ryd         , Zw          , Ryd         , Yl          , Yl          , Qxs         , Qxs         , Qxs         , Qxs         , Qxs         , Qxs         , Qxs         , Qxs         
Qxs         , Qxs         , Qxs         , Qxs         , Qxs         , Qxs         , Qxs         , Qxs         , Qxs         , Ryd         , Zw          , Yl          , Yl          , Ryd         , Qxs         , Qxs         , Qxs         , Qxs         , Qxs         , Qxs         , Qxs         , Qxs         
Qxs         , Qxs         , Qxs         , Qxs         , Qxs         , Qxs         , Qxs         , Qxs         , Qxs         , Yl          , Zw          , Zw          , Ryd         , Ryd         , Qxs         , Qxs         , Qxs         , Qxs         , Qxs         , Qxs         , Qxs         , Qxs         
Qxs         , Qxs         , Qxs         , Qxs         , Qxs         , Qxs         , Qxs         , Qxs         , Qxs         , Ryd         , Zw          , Ryd         , Zw          , Zw          , Qxs         , Qxs         , Qxs         , Qxs         , Qxs         , Qxs         , Qxs         , Qxs         
Qxs         , Qxs         , Qxs         , Qxs         , Qxs         , Qxs         , Qxs         , Qxs         , Qxs         , Yl          , Yl          , Zw          , Zw          , Yl          , Qxs         , Qxs         , Qxs         , Qxs         , Qxs         , Qxs         , Qxs         , Qxs         
Qxs         , Qxs         , Qxs         , Qxs         , Qxs         , Qxs         , Qxs         , Qxs         , Qxs         , Yl          , Yl          , Cud         , Zw          , Ryd         , Qxs         , Qxs         , Qxs         , Qxs         , Qxs         , Qxs         , Qxs         , Qxs         
Qxs         , Qxs         , Qxs         , Qxs         , Qxs         , Qxs         , Qxs         , Qxs         , Qxs         , Ryd         , Yl          , Zw          , Ryd         , Cud         , Qxs         , Qxs         , Qxs         , Qxs         , Qxs         , Qxs         , Qxs         , Qxs         
Qxs         , Qxs         , Qxs         , Qxs         , Qxs         , Qxs         , Qxs         , Qxs         , Qxs         , Ryd         , Zw          , Zw          , Yl          , Yl          , Qxs         , Qxs         , Qxs         , Qxs         , Qxs         , Qxs         , Qxs         , Qxs         
Qxs         , Qxs         , Qxs         , Qxs         , Qxs         , Qxs         , Qxs         , Qxs         , Qxs         , Ryd         , Zw          , Yl          , Yl          , Ryd         , Qxs         , Qxs         , Qxs         , Qxs         , Qxs         , Qxs         , Qxs         , Qxs         
Qxs         , Qxs         , Qxs         , Qxs         , Qxs         , Qxs         , Qxs         , Qxs         , Qxs         , Ryd         , Ryd         , Ryd         , Yl          , Ryd         , Qxs         , Qxs         , Qxs         , Qxs         , Qxs         , Qxs         , Qxs         , Qxs         
Qxs         , Qxs         , Qxs         , Qxs         , Qxs         , Qxs         , Qxs         , Qxs         , Qxs         , Yl          , Zw          , Ryd         , Zw          , Ryd         , Qxs         , Qxs         , Qxs         , Qxs         , Qxs         , Qxs         , Qxs         , Qxs         
Qxs         , Qxs         , Qxs         , Qxs         , Qxs         , Qxs         , Qxs         , Qxs         , Qxs         , Zw          , Yl          , Ryd         , Uu          , Zw          , Qxs         , Qxs         , Qxs         , Qxs         , Qxs         , Qxs         , Qxs         , Qxs         
Qxs         , Qxs         , Qxs         , Qxs         , Qxs         , Qxs         , Qxs         , Qxs         , Qxs         , Cud         , Yl          , Ryd         , Uu          , Zw          , Qxs         , Qxs         , Qxs         , Qxs         , Qxs         , Qxs         , Qxs         , Qxs         
Qxs         , Qxs         , Qxs         , Qxs         , Qxs         , Qxs         , Qxs         , Qxs         , Xv          , Yl          , Ryd         , Zw          , Zw          , Yl          , Xv          , Qxs         , Qxs         , Qxs         , Qxs         , Qxs         , Qxs         , Qxs         
Qxs         , Qxs         , Qxs         , Qxs         , Qxs         , Qxs         , Xv          , Xv          , Xv          , Yl          , Zw          , Ryd         , Yl          , Ryd         , Xv          , Xv          , Xv          , Qxs         , Qxs         , Qxs         , Qxs         , Qxs         
Qxs         , Qxs         , Qxs         , Qxs         , Xv          , Xv          , Xv          , Xv          , Xv          , Yl          , Ryd         , Ryd         , Yl          , Ryd         , Xv          , Xv          , Xv          , Xv          , Xv          , Qxs         , Qxs         , Qxs         
Qxs         , Qxs         , Xv          , Xv          , Xv          , Xv          , Xv          , Xv          , Xv          , Ryd         , Yl          , Ryd         , Uu          , Cud         , Xv          , Xv          , Xv          , Xv          , Xv          , Xv          , Xv          , Qxs         
Xv          , Xv          , Xv          , Xv          , Xv          , Xv          , Xv          , Xv          , Xv          , Ryd         , Ryd         , Uu          , Yl          , Ryd         , Xv          , Xv          , Xv          , Xv          , Xv          , Xv          , Xv          , Xv          
Xv          , Xv          , Xv          , Xv          , Xv          , Xv          , Xv          , Xv          , Xv          , Ryd         , Yl          , Ryd         , Yl          , Yl          , Xv          , Xv          , Xv          , Xv          , Xv          , Xv          , Xv          , Xv          
Xv          , Xv          , Xv          , Xv          , Xv          , Xv          , Xv          , Xv          , Ai          , Yl          , Uu          , Uu          , Ryd         , Ryd         , Ai          , Xv          , Xv          , Xv          , Xv          , Xv          , Xv          , Xv          
Xv          , Xv          , Xv          , Xv          , Xv          , Xv          , Ai          , Ai          , Ai          , Ryd         , Yl          , Yl          , Ryd         , Yl          , Ai          , Ai          , Ai          , Xv          , Xv          , Xv          , Xv          , Xv          
Xv          , Xv          , Xv          , Xv          , Xv          , Xv          , Ai          , Aa          , Ai          , Ryd         , Yl          , Yl          , Yl          , Yl          , Ai          , Aa          , Ai          , Xv          , Xv          , Xv          , Xv          , Xv          
Xv          , Xv          , Xv          , Xv          , Xv          , Xv          , Ai          , Aa          , Ai          , Yl          , Ryd         , Uu          , Ryd         , Uu          , Ai          , Aa          , Ai          , Xv          , Xv          , Xv          , Xv          , Xv          
Xv          , Xv          , Xv          , Xv          , Xv          , Xv          , Ai          , Aa          , Ai          , Yl          , Yl          , Yl          , Yl          , Uu          , Ai          , Aa          , Ai          , Xv          , Xv          , Xv          , Xv          , Xv          
Xv          , Xv          , Xv          , Xv          , Xv          , Xv          , Ai          , Aa          , Ai          , Yl          , Ryd         , Uu          , Uu          , Ryd         , Ai          , Aa          , Ai          , Xv          , Xv          , Xv          , Xv          , Xv          
Xv          , Xv          , Xv          , Xv          , Xv          , Xv          , Ai          , Aa          , Ai          , Ryd         , Uu          , Yl          , Yl          , Uu          , Ai          , Aa          , Ai          , Xv          , Xv          , Xv          , Xv          , Xv          
Xv          , Xv          , Xv          , Xv          , Xv          , Xv          , Ai          , Aa          , Ai          , Ryd         , Uu          , Ryd         , Yl          , Ryd         , Ai          , Aa          , Ai          , Xv          , Xv          , Xv          , Xv          , Xv          
Xv          , Xv          , Xv          , Xv          , Xv          , Xv          , Ai          , Aa          , Ai          , Yl          , Uu          , Yl          , Uu          , Uu          , Ai          , Aa          , Ai          , Xv          , Xv          , Xv          , Xv          , Xv          
Xv          , Xv          , Xv          , Xv          , Xv          , Xv          , Ai          , Aa          , Ai          , Ryd         , Uu          , Ryd         , Ryd         , Yl          , Ai          , Aa          , Ai          , Xv          , Xv          , Xv          , Xv          , Xv          
Xv          , Xv          , Xv          , Xv          , Ai          , Ai          , Aa          , Aa          , Ai          , Ryd         , Yl          , Yl          , Uu          , Yl          , Ai          , Aa          , Aa          , Ai          , Ai          , Xv          , Xv          , Xv          
Xv          , Xv          , Ai          , Ai          , Aa          , Aa          , Aa          , Aa          , Ai          , Yl          , Ryd         , Ryd         , Uu          , Yl          , Ai          , Aa          , Aa          , Aa          , Aa          , Ai          , Ai          , Xv          
Ai          , Ai          , Aa          , Aa          , Aa          , Aa          , Aa          , Aa          , Ai          , Ryd         , Yl          , Uu          , Yl          , Yl          , Ai          , Aa          , Aa          , Aa          , Aa          , Aa          , Aa          , Ai          
