border_size=1
usage=map

Xu          , Ryd         , Ryd         , Ryd         , Ryd         , Xu          , Xu          , Xu          , Ryd         , Rr          , Rr          , Rr          , Ryd         , Yr          , Ryd         , Rr          , Rr          , Rr          , Ryd         , Xu          , Xu          , Xu          , Ryd         , Ryd         , Ryd         , Ryd         , Xu          
Xu          , Xu          , Xu          , Ryd         , Xg^Zse      , Xg^Zse      , Ryd         , Yr          , Ryd         , Rr          , Rr          , Rr          , Ryd         , Yr          , Ryd         , Rr          , Rr          , Rr          , Ryd         , Yr          , Ryd         , Xg^Zsw      , Xg^Zsw      , Ryd         , Xu          , Xu          , Xu          
Xu          , Xu          , Xu          , Xu          , Ryd         , Ryd         , Ryd         , Yr          , Yr          , Ryd         , Ryd         , Ryd         , Yr          , 1 Yr        , Yr          , Ryd         , Ryd         , Ryd         , Yr          , Yr          , Ryd         , Ryd         , Ryd         , Xu          , Xu          , Xu          , Xu          
Xu          , Xu          , Ryd         , Ryd         , Qxs         , Qxs         , Ryd         , Yr          , Uu^Ii       , Yr          , Yr          , Yr          , Ryd         , Yr          , Ryd         , Yr          , Yr          , Yr          , Uu^Ii       , Yr          , Ryd         , Qxs         , Qxs         , Ryd         , Ryd         , Xu          , Xu          
Ryd         , Ryd         , Qxs         , Qxs         , Qxs         , Ryd         , Yr          , Yr          , Yrh         , Yr          , Ryd         , Yr          , Yr          , Yr          , Yr          , Yr          , Ryd         , Yr          , Yr          , Yr          , Yrh         , Ryd         , Qxs         , Qxs         , Qxs         , Ryd         , Ryd         
Qxs         , Qxs         , Qxs         , Qxs         , Ryd         , Ryd         , Yr          , Uh          , Yr          , Ryd         , Qxs         , Ryd         , Yr          , Uh          , Yr          , Ryd         , Qxs         , Ryd         , Yr          , Uh          , Yr          , Ryd         , Ryd         , Qxs         , Qxs         , Qxs         , Qxs         
Qxs         , Qxs         , Ryd         , Ryd         , Yr          , Yr          , Ryd         , Yr          , Yr          , Ryd         , Ryd         , Ryd         , Ryd         , Yr          , Ryd         , Ryd         , Ryd         , Ryd         , Yr          , Yr          , Ryd         , Yr          , Yr          , Ryd         , Ryd         , Qxs         , Qxs         
Ryd         , Ryd         , Yrh         , Yr          , Ryd         , Ryd         , Qxs         , Ryd         , Ryd         , Yrh         , Yr          , Ryd         , Ryd         , Yr          , Ryd         , Ryd         , Yrh         , Yr          , Ryd         , Ryd         , Qxs         , Ryd         , Ryd         , Yr          , Yr          , Ryd         , Ryd         
Yr          , Yr          , Ryd         , Ryd         , Qxs         , Qxs         , Qxs         , Qxs         , Qxs         , Ryd         , Ryd         , Yr          , Yr          , Yr          , Yr          , Yr          , Ryd         , Ryd         , Qxs         , Qxs         , Qxs         , Qxs         , Qxs         , Ryd         , Ryd         , Yr          , Yr          
Ryd         , Yr          , Yr          , Ryd         , Ryd         , Qxs         , Qxs         , Qxs         , Qxs         , Qxs         , Ryd         , Ryd         , Yr          , Uh          , Yr          , Ryd         , Ryd         , Qxs         , Qxs         , Qxs         , Qxs         , Qxs         , Ryd         , Ryd         , Yr          , Yr          , Ryd         
Qxs         , Ryd         , Ryd         , Yr          , Yr          , Ryd         , Ryd         , Qxs         , Ryd         , Ryd         , Yr          , Yr          , Ryd         , Yr          , Ryd         , Yr          , Yr          , Ryd         , Ryd         , Qxs         , Ryd         , Ryd         , Yr          , Yrh         , Ryd         , Ryd         , Qxs         
Qxs         , Qxs         , Qxs         , Ryd         , Ryd         , Yr          , Yr          , Uu^Ii       , Yr          , Yr          , Ryd         , Ryd         , Ryd         , Yr          , Ryd         , Ryd         , Ryd         , Yrh         , Yr          , Uu^Ii       , Yr          , Yr          , Ryd         , Ryd         , Qxs         , Qxs         , Qxs         
Qxs         , Qxs         , Qxs         , Qxs         , Ryd         , Yr          , Uh          , Yrh         , Ryd         , Ryd         , Qxs         , Qxs         , Ryd         , Yrh         , Ryd         , Qxs         , Qxs         , Ryd         , Ryd         , Yr          , Uh          , Yr          , Ryd         , Qxs         , Qxs         , Qxs         , Qxs         
Qxs         , Qxs         , Ryd         , Ryd         , Yr          , Yr          , Yr          , Yr          , Yr          , Ryd         , Ryd         , Qxs         , Ryd         , Yr          , Ryd         , Qxs         , Ryd         , Ryd         , Yr          , Yr          , Yr          , Yr          , Yr          , Ryd         , Ryd         , Qxs         , Qxs         
Ryd         , Ryd         , Yr          , Yr          , Ryd         , Ryd         , Yr          , Ryd         , Ryd         , Yr          , Yr          , Ryd         , Ryd         , Yr          , Ryd         , Ryd         , Yr          , Yr          , Ryd         , Ryd         , Yr          , Ryd         , Ryd         , Yr          , Yr          , Ryd         , Ryd         
Yr          , Yr          , Uu^Ii       , Yr          , Yr          , Ryd         , Yrh         , Ryd         , Ryd         , Yr          , Ryd         , Yr          , Uu^Cd       , Uu^Cd       , Uu^Cd       , Yrh         , Ryd         , Yr          , Ryd         , Ryd         , Yrh         , Ryd         , Yr          , Yr          , Uu^Ii       , Yr          , Yr          
Ryd         , Ryd         , Qxs         , Ryd         , Ryd         , Yr          , Yr          , Ryd         , Ryd         , Yr          , Ryd         , Ryd         , Uu^Cd       , Uu^Cd       , Uu^Cd       , Ryd         , Ryd         , Yr          , Ryd         , Ryd         , Yr          , Yr          , Ryd         , Ryd         , Qxs         , Ryd         , Ryd         
Yr          , Ryd         , Ryd         , Qxs         , Qxs         , Ryd         , Ryd         , Yr          , Uu^Cd       , Uu^Cd       , Uu^Cd       , Uu^Cd       , Qxs         , Uu^Cd       , Qxs         , Uu^Cd       , Uu^Cd       , Uu^Cd       , Uu^Cd       , Yr          , Ryd         , Ryd         , Qxs         , Qxs         , Ryd         , Ryd         , Yr          
Ryd         , Yr          , Yr          , Ryd         , Ryd         , Qxs         , Ryd         , Ryd         , Uu^Cd       , Uu^Cd       , Uu^Cd       , Qxs         , Qxs         , Uu^Cd       , Qxs         , Qxs         , Uu^Cd       , Uu^Cd       , Uu^Cd       , Ryd         , Ryd         , Qxs         , Ryd         , Ryd         , Yr          , Yr          , Ryd         
Qxs         , Ryd         , Ryd         , Yr          , Yr          , Ryd         , Yr          , Yr          , Ryd         , Uu^Cd       , Qxs         , Uu^Cd       , Uu^Cd       , Uu^Cd       , Uu^Cd       , Uu^Cd       , Qxs         , Uu^Cd       , Ryd         , Yr          , Yrh         , Ryd         , Yr          , Yr          , Ryd         , Ryd         , Qxs         
Qxs         , Qxs         , Ryd         , Ryd         , Yr          , Yrh         , Yr          , Ryd         , Ryd         , Uu^Cd       , Qxs         , Qxs         , Uu^Cd       , Uu^Kd       , Uu^Cd       , Qxs         , Qxs         , Uu^Cd       , Ryd         , Ryd         , Yr          , Yr          , Yr          , Ryd         , Ryd         , Qxs         , Qxs         
Ryd         , Ryd         , Yr          , Yr          , Ryd         , Ryd         , Ryd         , Yr          , Uu^Cd       , Uu^Cd       , Uu^Cd       , Uu^Cd       , Qxs         , Uu^Cd       , Qxs         , Uu^Cd       , Uu^Cd       , Uu^Cd       , Uu^Cd       , Yr          , Ryd         , Ryd         , Ryd         , Yr          , Yr          , Ryd         , Ryd         
Yrh         , Yr          , Yr          , Uh          , Ryd         , Qxs         , Ryd         , Ryd         , Uu^Cd       , Uu^Cd       , Uu^Cd       , Qxs         , Qxs         , Uu^Cd       , Qxs         , Qxs         , Uu^Cd       , Uu^Cd       , Uu^Cd       , Ryd         , Ryd         , Qxs         , Ryd         , Uh          , Yr          , Yr          , Yr          
Ryd         , Ryd         , Ryd         , Yr          , Yr          , Ryd         , Yr          , Yr          , Ryd         , Uu^Cd       , Ryd         , Uu^Cd       , Uu^Cd       , Uu^Cd       , Uu^Cd       , Uu^Cd       , Ryd         , Uu^Cd       , Ryd         , Yr          , Yr          , Ryd         , Yr          , Yrh         , Ryd         , Ryd         , Ryd         
Qxs         , Qxs         , Ryd         , Uu^Ii       , Yr          , Yr          , Yr          , Ryd         , Ryd         , Yr          , Ryd         , Ryd         , Uu^Cd       , Uu^Cd       , Uu^Cd       , Ryd         , Ryd         , Yr          , Ryd         , Ryd         , Yr          , Yr          , Yr          , Uu^Ii       , Ryd         , Qxs         , Qxs         
Ryd         , Ryd         , Yr          , Yr          , Ryd         , Ryd         , Ryd         , Yr          , Yr          , Yr          , Yr          , Yr          , Ryd         , Uu^Cd       , Ryd         , Yr          , Yr          , Yr          , Yr          , Yr          , Ryd         , Ryd         , Ryd         , Yr          , Yr          , Ryd         , Ryd         
Yr          , Yr          , Ryd         , Yr          , Yrh         , Ryd         , Ryd         , Ryd         , Yr          , Yrh         , Yr          , Ryd         , Ryd         , Yr          , Ryd         , Ryd         , Yr          , Yrh         , Yr          , Ryd         , Ryd         , Ryd         , Yr          , Yr          , Ryd         , Yrh         , Yr          
Ryd         , Ryd         , Qxs         , Ryd         , Ryd         , Yr          , Yr          , Yr          , Ryd         , Yr          , Ryd         , Yr          , Yr          , Yrh         , Yr          , Yr          , Ryd         , Yr          , Ryd         , Yr          , Yr          , Yr          , Ryd         , Ryd         , Qxs         , Ryd         , Ryd         
Ryd         , Qxs         , Qxs         , Qxs         , Qxs         , Ryd         , Ryd         , Yr          , Yr          , Yr          , Yrh         , Yr          , Ryd         , Yr          , Ryd         , Yr          , Yr          , Yr          , Yr          , Yr          , Ryd         , Ryd         , Qxs         , Qxs         , Qxs         , Qxs         , Ryd         
Xu          , Ryd         , Ryd         , Qxs         , Qxs         , Qxs         , Ryd         , Ryd         , Yr          , Uh          , Yr          , Ryd         , Ryd         , Yr          , Ryd         , Ryd         , Yrh         , Uh          , Yr          , Ryd         , Ryd         , Qxs         , Qxs         , Qxs         , Ryd         , Ryd         , Xu          
Xu          , Xu          , Xu          , Ryd         , Ryd         , Ryd         , Yr          , Yr          , Ryd         , Yr          , Uu^Ii       , Yr          , Yr          , Yr          , Yrh         , Yr          , Uu^Ii       , Yr          , Ryd         , Yr          , Yrh         , Ryd         , Ryd         , Ryd         , Xu          , Xu          , Xu          
Xu          , Xu          , Xu          , Xu          , Yr          , Yrh         , Ryd         , Ryd         , Ryd         , Yrh         , Ryd         , Ryd         , Yr          , Uh          , Yr          , Ryd         , Ryd         , Yr          , Ryd         , Ryd         , Ryd         , Yr          , Yr          , Xu          , Xu          , Xu          , Xu          
Xu          , Xu          , Yr          , Yr          , Xu          , Xu          , Xu          , Ryd         , Ryd         , Yr          , Ryd         , Ryd         , Ryd         , Yr          , Ryd         , Ryd         , Ryd         , Yrh         , Ryd         , Ryd         , Xu          , Xu          , Xu          , Yr          , Yr          , Xu          , Xu          
Yr          , Yr          , Xu          , Xu          , Xu          , Xu          , Xu          , Xu          , Xu          , Yr          , Ryd         , Qxs         , Ryd         , Yr          , Ryd         , Qxs         , Ryd         , Yr          , Xu          , Xu          , Xu          , Xu          , Xu          , Xu          , Xu          , Yr          , Yr          
